GRID
WL06 WL06 WL06 WL06 WL06 WL06 WL06 WL06 WL06 WL06 WL06 WL06 WL06 WL06 WL06 WL06 WL06 WL06 WL06 WL06 WL06 WL06 WL06 WL06 WL06 WL06 WL06 WL06 WL06 WL06
WL06 FL00 FL00 FL00 FL00 FL00 FL00 FL00 FL00 FL00 FL00 FL00 FL00 FL00 FL00 FL00 FL00 FL00 FL00 FL00 FL00 FL00 FL00 FL00 FL00 FL00 FL00 FL00 FL00 WL06
WL06 FL00 FL00 FL00 FL00 FL00 FL00 FL00 FL00 FL00 FL00 FL00 FL00 FL00 FL00 FL00 FL00 FL00 FL00 FL00 FL00 FL00 FL00 FL00 FL00 FL00 FL00 FL00 FL00 WL06
WL06 FL00 FL00 FL00 FL00 FL00 FL00 FL00 FL00 FL00 FL00 FL00 FL00 FL00 FL00 FL00 FL00 FL00 FL00 FL00 FL00 FL00 FL00 FL00 FL00 FL00 FL00 FL00 FL00 WL06
WL06 FL00 FL00 FL00 FL00 FL00 FL00 FL23 FL00 FL00 FL00 FL00 FL00 FL00 FL00 FL00 FL00 FL00 FL00 FL00 FL00 FL00 FL00 FL00 FL00 FL00 FL00 FL00 FL00 WL06
WL06 FL00 FL00 FL00 FL00 FL00 FL23 FL23 FL00 FL00 FL00 FL00 FL00 FL00 FL00 FL00 FL00 FL00 FL00 FL00 FL00 FL00 FL00 FL00 FL00 FL00 FL00 FL00 FL00 WL06
WL06 FL00 FL00 FL00 FL00 FL23 FL23 FL00 FL00 FL00 FL23 FL23 FL23 FL23 FL23 FL23 FL00 FL00 FL00 FL00 FL00 FL00 FL00 FL00 FL00 FL00 FL00 FL00 FL00 WL06
WL06 FL00 FL00 FL00 FL00 FL23 FL00 FL00 FL00 FL00 FL00 FL00 FL00 FL00 FL00 FL23 FL00 FL00 FL00 FL00 FL00 FL00 FL00 FL00 FL00 FL00 FL00 FL00 FL00 WL06
WL06 FL00 FL00 FL00 FL00 FL23 FL00 FL00 FL00 FL00 FL00 FL00 FL00 FL00 FL00 FL23 FL23 FL00 FL00 FL00 FL00 FL00 FL00 FL00 FL00 FL00 FL00 FL00 FL00 WL06
WL06 FL00 FL00 FL00 FL00 FL23 FL00 FL00 FL00 FL00 FL00 FL00 FL00 FL00 FL00 FL00 FL23 FL00 FL00 FL00 FL00 FL00 FL00 FL00 FL00 FL00 FL00 FL00 FL00 WL06
WL06 FL00 FL00 FL00 FL00 FL23 FL00 FL00 FL00 FL00 FL00 FL00 FL00 FL00 FL00 FL00 FL23 FL00 FL00 FL00 FL00 FL00 FL00 FL00 FL00 FL00 FL00 FL00 FL00 WL06
WL06 FL00 FL00 FL00 FL00 FL23 FL23 FL00 FL00 FL00 FL00 FL00 FL00 FL00 FL00 FL00 FL23 FL00 FL00 FL00 FL00 FL00 FL00 FL00 FL00 FL00 FL00 FL00 FL00 WL06
WL06 FL00 FL00 FL00 FL00 FL00 FL23 FL23 FL00 FL00 FL00 FL00 FL00 FL00 FL00 FL23 FL23 FL00 FL00 FL00 FL00 FL00 FL00 FL00 FL00 FL00 FL00 FL00 FL00 WL06
WL06 FL00 FL00 FL00 FL00 FL00 FL00 FL23 FL23 FL23 FL23 FL00 FL23 FL23 FL23 FL23 FL00 FL00 FL00 FL00 FL00 FL00 FL00 FL00 FL00 FL00 FL00 FL00 FL00 WL06
WL06 FL00 FL00 FL00 FL00 FL00 FL00 FL00 FL00 FL00 FL00 FL23 FL23 FL00 FL00 FL00 FL00 FL00 FL00 FL00 FL00 FL00 FL00 FL00 FL00 FL00 FL00 FL00 FL00 WL06
WL06 FL00 FL00 FL00 FL00 FL00 FL00 FL00 FL00 FL00 FL00 FL00 FL00 FL00 FL00 FL00 FL00 FL00 FL00 FL00 FL00 FL00 FL00 FL00 FL00 FL00 FL00 FL00 FL00 WL06
WL06 FL00 FL00 FL00 FL00 FL00 FL00 FL00 FL00 FL00 FL00 FL00 FL00 FL00 FL00 FL00 FL00 FL00 FL00 FL00 FL00 FL00 FL00 FL00 FL00 FL00 FL00 FL00 FL00 WL06
WL06 FL00 FL00 FL00 FL00 FL00 FL00 FL00 FL00 FL00 FL00 FL00 FL00 FL00 FL00 FL00 FL00 FL00 FL00 FL00 FL00 FL00 FL00 FL00 FL00 FL00 FL00 FL00 FL00 WL06
WL06 FL00 FL00 FL00 FL00 FL00 FL00 FL00 FL00 FL00 FL00 FL00 FL00 FL00 FL00 FL00 FL00 FL00 FL00 FL00 FL00 FL00 FL00 FL00 FL00 FL00 FL00 FL00 FL00 WL06
WL06 WL06 WL06 WL06 WL06 WL06 WL06 WL06 WL06 WL06 WL06 WL06 WL06 WL06 WL06 WL06 WL06 WL06 WL06 WL06 WL06 WL06 WL06 WL06 WL06 WL06 WL06 WL06 WL06 WL06
