# Generated from /Users/janimattiellonen/Documents/Development/fog-of-war/docs/example2.png

GRID
W00 W00 W00 W00 W00 W00 W00 W00 W00 W00 W00 W00 W00 W00 W00 W00 W00 W00 W00 W00 W00 W00 W00 W00 W00 W00 W00 W00 W00 W00 W00 W00 W00 W00 W00 W00 W00 W00 W00 W00 W00 W00 W00 W00 W00 W00 W00 W00 W00 W00
W00 F00 F00 F00 F00 F00 F00 F00 F00 F00 F00 F00 F00 F00 F00 F00 F00 F00 F00 F00 F00 F00 F00 F00 F00 F00 F00 F00 F00 F00 F00 F00 F00 F00 F00 F00 F00 F00 F00 F00 F00 F00 F00 F00 F00 F00 F00 F00 F00 W00
W00 F00 F00 F00 F00 F00 F00 F00 F00 F00 F00 F00 F00 F00 F00 F00 F00 F00 F00 F00 F00 F00 F00 F00 F00 F00 F00 F00 F00 F00 F00 F00 F00 F00 F00 F00 F00 F00 F00 F00 F00 F00 F00 F00 F00 F00 F00 F00 F00 W00
W00 F00 F00 F00 F00 F00 F00 F00 F00 F00 F00 F00 F00 F00 F00 F00 F00 F00 F00 F00 F00 F00 F00 F00 F00 F00 F00 F00 F00 F00 F00 F00 F00 F00 F00 F00 F00 F00 F00 F00 F00 F00 F00 F00 F00 F00 F00 F00 F00 W00
W00 F00 F00 F00 F00 F00 F00 F00 F00 F00 F00 F00 F00 F00 F00 F00 F00 F00 F00 F00 F00 F00 F00 F00 F00 F00 F00 F00 F00 F00 F00 F00 F00 F00 F00 F00 F00 F00 F00 F00 F00 F00 F00 F00 F00 F00 F00 F00 F00 W00
W00 F00 F00 F00 F00 F00 F00 F00 F00 F00 F00 F00 F00 F00 F00 F00 F00 F00 F00 F00 F00 F00 F00 F00 F00 F00 F00 F00 F00 F00 F00 F00 F00 F00 F00 F00 F00 F00 F00 F00 F00 F00 F00 F00 F00 F00 F00 F00 F00 W00
W00 F00 F00 F00 F00 F00 F00 F00 F00 F00 F00 F00 F00 F00 F00 F00 F00 F00 F00 F00 F00 F00 F00 F00 F00 F00 F00 F00 F00 F00 F00 F00 F00 F00 F00 F00 F00 F00 F00 F00 F00 F00 F00 F00 F00 F00 F00 F00 F00 W00
W00 F00 F00 F00 F00 F00 F00 F00 F00 F00 F00 F00 F00 F00 F00 F00 F00 F00 F00 F00 F00 F00 F00 F00 F00 F00 F00 F00 F00 F00 F00 F00 F00 F00 F00 F00 F00 F00 F00 F00 F00 F00 F00 F00 F00 F00 F00 F00 F00 W00
W00 F00 F00 F00 F00 F00 F00 F00 F00 F00 F00 F00 F00 F00 F00 F00 F00 F00 F00 F00 F00 F00 F00 F00 F00 F00 F00 F00 F00 F00 F00 F00 F00 F00 F00 F00 F00 F00 F00 F00 F00 F00 F00 F00 F00 F00 F00 F00 F00 W00
W00 F00 F00 F00 F00 F00 F00 F00 F00 F00 F00 F00 F00 F00 F00 F00 F00 F00 F00 F00 F00 F00 F00 F00 F00 F00 F00 F00 F00 F00 F00 F00 F00 F00 F00 F00 F00 F00 F00 F00 F00 F00 F00 F00 F00 F00 F00 F00 F00 W00
W00 F00 F00 F00 F00 F00 F00 F00 F00 F00 F00 F00 F00 F00 F00 F00 W00 W00 W00 W00 F00 F00 F00 F00 F00 F00 F00 F00 F00 F00 W00 W00 W00 W00 F00 F00 F00 F00 F00 F00 F00 F00 F00 F00 F00 F00 F00 F00 F00 W00
W00 F00 F00 F00 F00 F00 F00 F00 F00 F00 F00 F00 F00 F00 F00 F00 W00 W00 W00 W00 F00 F00 F00 F00 F00 F00 F00 F00 F00 F00 W00 W00 W00 W00 F00 F00 F00 F00 F00 F00 F00 F00 F00 F00 F00 F00 F00 F00 F00 W00
W00 F00 F00 F00 F00 F00 F00 F00 F00 F00 F00 F00 F00 F00 F00 F00 W00 W00 W00 W00 F00 F00 F00 F00 F00 F00 F00 F00 F00 F00 W00 W00 W00 W00 F00 F00 F00 F00 F00 F00 F00 F00 F00 F00 F00 F00 F00 F00 F00 W00
W00 F00 F00 F00 F00 F00 F00 F00 F00 F00 F00 F00 F00 F00 F00 F00 W00 W00 W00 W00 F00 F00 F00 F00 F00 F00 F00 F00 F00 F00 W00 W00 W00 W00 F00 F00 F00 F00 F00 F00 F00 F00 F00 F00 F00 F00 F00 F00 F00 W00
W00 F00 F00 F00 F00 F00 F00 F00 F00 F00 F00 F00 F00 F00 F00 F00 F00 F00 F00 F00 F00 F00 F00 F00 F00 F00 F00 F00 F00 F00 F00 F00 F00 F00 F00 F00 F00 F00 F00 F00 F00 F00 F00 F00 F00 F00 F00 F00 F00 W00
W00 F00 F00 F00 F00 F00 F00 F00 F00 F00 F00 F00 F00 F00 F00 F00 F00 F00 F00 F00 F00 F00 F00 F00 F00 F00 F00 F00 F00 F00 F00 F00 F00 F00 F00 F00 F00 F00 F00 F00 F00 F00 F00 F00 F00 F00 F00 F00 F00 W00
W00 F00 F00 F00 F00 F00 F00 F00 F00 F00 F00 F00 F00 F00 F00 F00 F00 F00 F00 F00 F00 F00 F00 F00 F00 F00 F00 F00 F00 F00 F00 F00 F00 F00 F00 F00 F00 F00 F00 F00 F00 F00 F00 F00 F00 F00 F00 F00 F00 W00
W00 F00 F00 F00 F00 F00 F00 F00 F00 F00 F00 F00 F00 F00 F00 F00 F00 F00 F00 F00 F00 F00 F00 W00 W00 W00 W00 F00 F00 F00 F00 F00 F00 F00 F00 F00 F00 F00 F00 F00 F00 F00 F00 F00 F00 F00 F00 F00 F00 W00
W00 F00 F00 F00 F00 F00 F00 F00 F00 F00 F00 F00 F00 F00 F00 F00 F00 F00 F00 F00 F00 F00 F00 W00 W00 W00 W00 F00 F00 F00 F00 F00 F00 F00 F00 F00 F00 F00 F00 F00 F00 F00 F00 F00 F00 F00 F00 F00 F00 W00
W00 F00 F00 F00 F00 F00 F00 F00 F00 F00 F00 F00 F00 F00 F00 F00 F00 F00 F00 F00 F00 F00 F00 W00 W00 W00 W00 F00 F00 F00 F00 F00 F00 F00 F00 F00 F00 F00 F00 F00 F00 F00 F00 F00 F00 F00 F00 F00 F00 W00
W00 F00 F00 F00 F00 F00 F00 F00 F00 F00 F00 F00 F00 F00 F00 F00 F00 F00 F00 F00 F00 F00 F00 W00 W00 W00 W00 F00 F00 F00 F00 F00 F00 F00 F00 F00 F00 F00 F00 F00 F00 F00 F00 F00 F00 F00 F00 F00 F00 W00
W00 F00 F00 F00 F00 F00 F00 F00 F00 F00 F00 F00 F00 F00 F00 F00 F00 F00 F00 F00 F00 F00 F00 F00 F00 F00 F00 F00 F00 F00 F00 F00 F00 F00 F00 F00 F00 F00 F00 F00 F00 F00 F00 F00 F00 F00 F00 F00 F00 W00
W00 F00 F00 F00 F00 F00 F00 F00 F00 F00 F00 F00 W00 W00 W00 W00 F00 F00 F00 F00 F00 F00 F00 F00 F00 F00 F00 F00 F00 F00 F00 F00 F00 F00 W00 W00 W00 W00 F00 F00 F00 F00 F00 F00 F00 F00 F00 F00 F00 W00
W00 F00 F00 F00 F00 F00 F00 F00 F00 F00 F00 F00 W00 W00 W00 W00 F00 F00 F00 F00 F00 F00 F00 F00 F00 F00 F00 F00 F00 F00 F00 F00 F00 F00 W00 W00 W00 W00 F00 F00 F00 F00 F00 F00 F00 F00 F00 F00 F00 W00
W00 F00 F00 F00 F00 F00 F00 F00 F00 F00 F00 F00 W00 W00 W00 W00 F00 F00 F00 F00 F00 F00 F00 F00 F00 F00 F00 F00 F00 F00 F00 F00 F00 F00 W00 W00 W00 W00 F00 F00 F00 F00 F00 F00 F00 F00 F00 F00 F00 W00
W00 F00 F00 F00 F00 F00 F00 F00 F00 F00 F00 F00 W00 W00 W00 W00 F00 F00 F00 F00 F00 F00 F00 F00 F00 F00 F00 F00 F00 F00 F00 F00 F00 F00 W00 W00 W00 W00 F00 F00 F00 F00 F00 F00 F00 F00 F00 F00 F00 W00
W00 F00 F00 F00 F00 F00 F00 F00 F00 F00 F00 F00 F00 F00 F00 F00 W00 W00 W00 W00 W00 W00 W00 W00 W00 W00 W00 W00 W00 W00 W00 W00 W00 W00 F00 F00 F00 F00 F00 F00 F00 F00 F00 F00 F00 F00 F00 F00 F00 W00
W00 F00 F00 F00 F00 F00 F00 F00 F00 F00 F00 F00 F00 F00 F00 F00 W00 W00 W00 W00 W00 W00 W00 W00 W00 W00 W00 W00 W00 W00 W00 W00 W00 W00 F00 F00 F00 F00 F00 F00 F00 F00 F00 F00 F00 F00 F00 F00 F00 W00
W00 F00 F00 F00 F00 F00 F00 F00 F00 F00 F00 F00 F00 F00 F00 F00 W00 W00 W00 W00 W00 W00 W00 W00 W00 W00 W00 W00 W00 W00 W00 W00 W00 W00 F00 F00 F00 F00 F00 F00 F00 F00 F00 F00 F00 F00 F00 F00 F00 W00
W00 F00 F00 F00 F00 F00 F00 F00 F00 F00 F00 F00 F00 F00 F00 F00 W00 W00 W00 W00 W00 W00 W00 W00 W00 W00 W00 W00 W00 W00 W00 W00 W00 W00 F00 F00 F00 F00 F00 F00 F00 F00 F00 F00 F00 F00 F00 F00 F00 W00
W00 F00 F00 F00 F00 F00 F00 F00 F00 F00 F00 F00 F00 F00 F00 F00 F00 F00 F00 F00 F00 F00 F00 F00 F00 F00 F00 F00 F00 F00 F00 F00 F00 F00 F00 F00 F00 F00 F00 F00 F00 F00 F00 F00 F00 F00 F00 F00 F00 W00
W00 F00 F00 F00 F00 F00 F00 F00 F00 F00 F00 F00 F00 F00 F00 F00 F00 F00 F00 F00 F00 F00 F00 F00 F00 F00 F00 F00 F00 F00 F00 F00 F00 F00 F00 F00 F00 F00 F00 F00 F00 F00 F00 F00 F00 F00 F00 F00 F00 W00
W00 F00 F00 F00 F00 F00 F00 F00 F00 F00 F00 F00 F00 F00 F00 F00 F00 F00 F00 F00 F00 F00 F00 F00 F00 F00 F00 F00 F00 F00 F00 F00 F00 F00 F00 F00 F00 F00 F00 F00 F00 F00 F00 F00 F00 F00 F00 F00 F00 W00
W00 F00 F00 F00 F00 F00 F00 F00 F00 F00 F00 F00 F00 F00 F00 F00 F00 F00 F00 F00 F00 F00 F00 F00 F00 F00 F00 F00 F00 F00 F00 F00 F00 F00 F00 F00 F00 F00 F00 F00 F00 F00 F00 F00 F00 F00 F00 F00 F00 W00
W00 F00 F00 F00 F00 F00 F00 F00 F00 F00 F00 F00 F00 F00 F00 F00 F00 F00 F00 F00 F00 F00 F00 F00 F00 F00 F00 F00 F00 F00 F00 F00 F00 F00 F00 F00 F00 F00 F00 F00 F00 F00 F00 F00 F00 F00 F00 F00 F00 W00
W00 F00 F00 F00 F00 F00 F00 F00 F00 F00 F00 F00 F00 F00 F00 F00 F00 F00 F00 F00 F00 F00 F00 F00 F00 F00 F00 F00 F00 F00 F00 F00 F00 F00 F00 F00 F00 F00 F00 F00 F00 F00 F00 F00 F00 F00 F00 F00 F00 W00
W00 F00 F00 F00 F00 F00 F00 F00 F00 F00 F00 F00 F00 F00 F00 F00 F00 F00 F00 F00 F00 F00 F00 F00 F00 F00 F00 F00 F00 F00 F00 F00 F00 F00 F00 F00 F00 F00 F00 F00 F00 F00 F00 F00 F00 F00 F00 F00 F00 W00
W00 F00 F00 F00 F00 F00 F00 F00 F00 F00 F00 F00 F00 F00 F00 F00 F00 F00 F00 F00 F00 F00 F00 F00 F00 F00 F00 F00 F00 F00 F00 F00 F00 F00 F00 F00 F00 F00 F00 F00 F00 F00 F00 F00 F00 F00 F00 F00 F00 W00
W00 F00 F00 F00 F00 F00 F00 F00 F00 F00 F00 F00 F00 F00 F00 F00 F00 F00 F00 F00 F00 F00 F00 F00 F00 F00 F00 F00 F00 F00 F00 F00 F00 F00 F00 F00 F00 F00 F00 F00 F00 F00 F00 F00 F00 F00 F00 F00 F00 W00
W00 F00 F00 F00 F00 F00 F00 F00 F00 F00 F00 F00 F00 F00 F00 F00 F00 F00 F00 F00 F00 F00 F00 F00 F00 F00 F00 F00 F00 F00 F00 F00 F00 F00 F00 F00 F00 F00 F00 F00 F00 F00 F00 F00 F00 F00 F00 F00 F00 W00
W00 F00 F00 F00 F00 F00 F00 F00 F00 F00 F00 F00 F00 F00 F00 F00 F00 F00 F00 F00 F00 F00 F00 F00 F00 F00 F00 F00 F00 F00 F00 F00 F00 F00 F00 F00 F00 F00 F00 F00 F00 F00 F00 F00 F00 F00 F00 F00 F00 W00
W00 F00 F00 F00 F00 F00 F00 F00 F00 F00 F00 F00 F00 F00 F00 F00 F00 F00 F00 F00 F00 F00 F00 F00 F00 F00 F00 F00 F00 F00 F00 F00 F00 F00 F00 F00 F00 F00 F00 F00 F00 F00 F00 F00 F00 F00 F00 F00 F00 W00
W00 F00 F00 F00 F00 F00 F00 F00 F00 F00 F00 F00 F00 F00 F00 F00 F00 F00 F00 F00 F00 F00 F00 F00 F00 F00 F00 F00 F00 F00 F00 F00 F00 F00 F00 F00 F00 F00 F00 F00 F00 F00 F00 F00 F00 F00 F00 F00 F00 W00
W00 F00 F00 F00 F00 F00 F00 F00 F00 F00 F00 F00 F00 F00 F00 F00 F00 F00 F00 F00 F00 F00 F00 F00 F00 F00 F00 F00 F00 F00 F00 F00 F00 F00 F00 F00 F00 F00 F00 F00 F00 F00 F00 F00 F00 F00 F00 F00 F00 W00
W00 F00 F00 F00 F00 F00 F00 F00 F00 F00 F00 F00 F00 F00 F00 F00 F00 F00 F00 F00 F00 F00 F00 F00 F00 F00 F00 F00 F00 F00 F00 F00 F00 F00 F00 F00 F00 F00 F00 F00 F00 F00 F00 F00 F00 F00 F00 F00 F00 W00
W00 F00 F00 F00 F00 F00 F00 F00 F00 F00 F00 F00 F00 F00 F00 F00 F00 F00 F00 F00 F00 F00 F00 F00 F00 F00 F00 F00 F00 F00 F00 F00 F00 F00 F00 F00 F00 F00 F00 F00 F00 F00 F00 F00 F00 F00 F00 F00 F00 W00
W00 F00 F00 F00 F00 F00 F00 F00 F00 F00 F00 F00 F00 F00 F00 F00 F00 F00 F00 F00 F00 F00 F00 F00 F00 F00 F00 F00 F00 F00 F00 F00 F00 F00 F00 F00 F00 F00 F00 F00 F00 F00 F00 F00 F00 F00 F00 F00 F00 W00
W00 F00 F00 F00 F00 F00 F00 F00 F00 F00 F00 F00 F00 F00 F00 F00 F00 F00 F00 F00 F00 F00 F00 F00 F00 F00 F00 F00 F00 F00 F00 F00 F00 F00 F00 F00 F00 F00 F00 F00 F00 F00 F00 F00 F00 F00 F00 F00 F00 W00
W00 F00 F00 F00 F00 F00 F00 F00 F00 F00 F00 F00 F00 F00 F00 F00 F00 F00 F00 F00 F00 F00 F00 F00 F00 F00 F00 F00 F00 F00 F00 F00 F00 F00 F00 F00 F00 F00 F00 F00 F00 F00 F00 F00 F00 F00 F00 F00 F00 W00
W00 W00 W00 W00 W00 W00 W00 W00 W00 W00 W00 W00 W00 W00 W00 W00 W00 W00 W00 W00 W00 W00 W00 W00 W00 W00 W00 W00 W00 W00 W00 W00 W00 W00 W00 W00 W00 W00 W00 W00 W00 W00 W00 W00 W00 W00 W00 W00 W00 W00
