GRID
W04 W04 W04 W04 W04 W04 W04 W04 W04 W04 W04 W04 W04 W04 W04 W04 W04 W04 W04 W04 W06 W06 W06 W06 W06 W06 W06 W06 W06 W06
W04 F00 F00 F00 F00 F00 F00 F00 F00 F00 F00 F00 F00 F00 F00 F00 F00 F00 F00 F00 F00 F00 F00 F00 F00 F00 F00 F00 F00 W06
W04 F00 F00 F00 F00 F00 F00 F00 F00 F00 F00 F00 F00 F00 F00 F00 F00 F00 F00 F00 F00 F00 F00 F00 F00 F00 F00 F00 F00 W06
W04 F00 F00 F00 F00 F00 F00 F00 F00 F00 W04 W04 W04 W04 W04 W04 F00 W04 W04 F00 F00 F00 F00 F00 F00 F00 F00 F00 F00 W06
W04 F00 F00 F00 F00 F00 F00 F00 F00 F00 W04 W04 W04 W04 W04 F00 F00 F00 W04 F00 F00 F00 F00 F00 F00 F00 F00 F00 F00 W06
W04 F00 F00 F00 F00 W04 W04 W04 W04 F00 F00 F00 F00 F00 F00 F00 F00 F00 W04 F00 F00 F00 F00 F00 F00 F00 F00 F00 F00 W06
W04 F00 F00 F00 F00 F00 F00 F00 F00 W04 F00 F00 F00 F00 F00 F00 F00 W04 F00 F00 F00 F00 F00 F00 F00 F00 F00 F00 F00 W06
W04 F00 F00 F00 F00 F00 F00 W04 W04 W04 F00 W04 F00 F00 F00 F00 F00 W04 F00 F00 F00 F00 F00 F00 F00 F00 F00 F00 F00 W06
W04 F00 F00 F00 F00 F00 F00 W04 F00 W04 W04 W04 F00 F00 F00 F00 W04 W04 F00 F00 F00 F00 F00 F00 F00 F00 F00 F00 F00 W06
W02 F00 F00 F00 F00 F00 F00 W04 W04 W04 W04 W04 F00 F00 F00 F00 W04 W04 W04 F00 F00 F00 F00 F00 F00 F00 F00 F00 F00 W06
W06 F00 F00 F00 F00 F00 F00 F00 F00 W04 F00 F00 W04 F00 F00 F00 W04 F00 W04 F00 F00 F00 F00 F00 F00 F00 F00 F00 F00 W06
W06 F00 F00 F00 F00 F00 F00 F00 F00 F00 F00 F00 F00 W04 W04 W04 F00 W04 W04 F00 F00 F00 F00 F00 F00 F00 F00 F00 F00 W06
W06 F00 F00 F00 F00 F00 F00 F00 F00 F00 F00 F00 F00 F00 W04 W04 F00 W04 F00 F00 F00 F00 F00 F00 F00 F00 F00 F00 F00 W06
W06 F00 F00 F00 F00 F00 F00 F00 F00 F00 F00 F00 F00 F00 W04 W04 W04 W04 F00 F00 F00 F00 F00 F00 F00 F00 F00 F00 F00 W06
W06 F00 F00 F00 F00 F00 F00 F00 F00 F00 F00 F00 F00 F00 F00 F00 F00 F00 F00 F00 F00 F00 F00 F00 F00 F00 F00 F00 F00 W06
W06 F00 F00 F00 F00 F00 F00 F00 F00 F00 F00 F00 F00 F00 F00 F00 F00 F00 F00 F00 F00 F00 F00 F00 F00 F00 F00 F00 F00 W06
W06 F00 F00 F00 F00 F00 F00 F00 F00 F00 F00 F00 F00 F00 F00 F00 F00 F00 F00 F00 F00 F00 F00 F00 F00 F00 F00 F00 F00 W06
W06 F00 F00 F00 F00 F00 F00 F00 F00 F00 F00 F00 F00 F00 F00 F00 F00 F00 F00 F00 F00 F00 F00 F00 F00 F00 F00 F00 F00 W06
W06 F00 F00 F00 F00 F00 F00 F00 F00 F00 F00 F00 F00 F00 F00 F00 F00 F00 F00 F00 F00 F00 F00 F00 F00 F00 F00 F00 F00 W06
W06 W06 W06 W06 W06 W06 W06 W06 W06 W06 W06 W06 W06 W06 W06 W06 W06 W06 W06 W06 W06 W06 W06 W06 W06 W06 W06 W06 W06 W06
