# Fog of War - Demo Map

GRID
WL00 WL00 WL00 WL00 WL00 WL00 WL00 WL00 WL00 WL00 WL00 WL00 WL00 WL00 WL00 WL00 WL00 WL00 WL00 WL00 WL00 WL00 WL00 WL00 WL00 WL00 WL00 WL00 WL00 WL00 WL00 WL00 WL00 WL00 WL00 WL00 WL00 WL00 WL00 WL00 WL00 WL00 WL00 WL00 WL00 WL00 WL00 WL00 WL00 WL00 WL00 WL00 WL00 WL00 WL00 WL00 WL00 WL00 WL00 WL00 WL00 WL00 WL00 WL00 WL00 WL00 WL00 WL00 WL00 WL00 WL00 WL00 WL00 WL00 WL00 WL00 WL00 WL00 WL00 WL00 WL00 WL00 WL00 WL00 WL00 WL00 WL00 WL00 WL00 WL00 WL00 WL00 WL00 WL00
WL00 FL00 FL00 FL00 FL00 FL00 FL00 FL00 FL00 FL00 FL00 FL00 FL00 FL00 FL00 FL00 FL00 FL00 FL00 FL00 FL00 FL00 FL00 FL00 FL00 FL00 FL00 FL00 FL00 FL00 FL00 FL00 FL00 FL00 FL00 FL00 FL00 FL00 FL00 FL00 FL00 FL00 FL00 FL00 FL00 FL00 FL00 FL00 FL00 FL00 FL00 FL00 FL00 FL00 FL00 FL00 FL00 FL00 FL00 FL00 FL00 FL00 FL00 FL00 FL00 FL00 FL00 FL00 FL00 FL00 FL00 FL00 FL00 FL00 FL00 FL00 FL00 FL00 FL00 FL00 FL00 FL00 FL00 FL00 FL00 FL00 FL00 FL00 FL00 FL00 FL00 FL00 FL00 WL00
WL00 FL00 WL00 WL00 WL00 FL00 FL00 FL00 FL00 FL00 FL00 FL00 FL00 FL00 FL00 FL00 FL00 FL00 FL00 FL00 FL00 FL00 FL00 FL00 FL00 FL00 FL00 FL00 FL00 FL00 FL00 FL00 FL00 FL00 FL00 FL00 FL00 FL00 FL00 FL00 FL00 FL00 FL00 FL00 FL00 FL00 FL00 FL00 FL00 FL00 FL00 FL00 FL00 FL00 FL00 FL00 FL00 FL00 FL00 FL00 FL00 FL00 FL00 FL00 FL00 FL00 FL00 FL00 FL00 FL00 FL00 FL00 FL00 FL00 FL00 FL00 FL00 FL00 FL00 FL00 FL00 FL00 FL00 FL00 FL00 FL00 FL00 FL00 FL00 FL00 FL00 FL00 FL00 WL00
WL00 FL00 WL00 FL00 FL00 FL00 FL00 FL00 FL00 FL00 FL00 FL00 FL00 FL00 FL00 FL00 FL00 FL00 FL00 FL00 FL00 FL00 FL00 FL00 FL00 FL00 FL00 FL00 FL00 FL00 FL00 FL00 FL00 FL00 FL00 FL00 FL00 FL00 FL00 FL00 FL00 FL00 FL00 FL00 FL00 FL00 FL00 FL00 FL00 FL00 FL00 FL00 FL00 FL00 FL00 FL00 FL00 FL00 FL00 FL00 FL00 FL00 FL00 FL00 FL00 FL00 FL00 FL00 FL00 FL00 FL00 FL00 FL00 FL00 FL00 FL00 FL00 FL00 FL00 FL00 FL00 FL00 FL00 FL00 FL00 FL00 FL00 FL00 FL00 FL00 FL00 FL00 FL00 WL00
WL00 FL00 WL00 FL00 FL00 FL00 FL00 FL00 FL00 FL00 FL00 FL00 FL00 FL00 FL00 FL00 FL00 FL00 FL00 FL00 FL00 FL00 FL00 FL00 FL00 FL00 FL00 FL00 FL00 FL00 FL00 FL00 FL00 FL00 FL00 FL00 FL00 FL00 FL00 FL00 FL00 FL00 FL00 FL00 FL00 FL00 FL00 FL00 FL00 FL00 FL00 FL00 FL00 FL00 FL00 FL00 FL00 FL00 FL00 FL00 FL00 FL00 FL00 FL00 FL00 FL00 FL00 FL00 FL00 FL00 FL00 FL00 FL00 FL00 FL00 FL00 FL00 FL00 FL00 FL00 FL00 FL00 FL00 FL00 FL00 FL00 FL00 FL00 FL00 FL00 FL00 FL00 FL00 WL00
WL00 FL00 WL00 FL00 FL00 FL00 FL00 FL00 FL00 FL00 FL00 FL00 FL00 FL00 FL00 FL00 FL00 FL00 FL00 FL00 FL00 FL00 FL00 FL00 FL00 FL00 FL00 FL00 FL00 FL00 FL00 FL00 FL00 FL00 FL00 FL00 FL00 FL00 FL00 FL00 FL00 FL00 FL00 FL00 FL00 FL00 FL00 FL00 FL00 FL00 FL00 FL00 FL00 FL00 FL00 FL00 FL00 FL00 FL00 FL00 FL00 FL00 FL00 FL00 FL00 FL00 FL00 FL00 FL00 FL00 FL00 FL00 FL00 FL00 FL00 FL00 FL00 FL00 FL00 FL00 FL00 FL00 FL00 FL00 FL00 FL00 FL00 FL00 FL00 FL00 FL00 FL00 FL00 WL00
WL00 FL00 WL00 WL00 WL00 FL00 FL00 FL00 FL00 FL00 FL00 FL00 FL00 FL00 FL00 FL00 FL00 FL00 FL00 FL00 FL00 FL00 FL00 FL00 FL00 FL00 FL00 FL00 FL00 FL00 FL00 FL00 FL00 FL00 FL00 FL00 FL00 FL00 FL00 FL00 FL00 FL00 FL00 FL00 FL00 FL00 FL00 FL00 FL00 FL00 FL00 FL00 FL00 FL00 FL00 FL00 FL00 FL00 FL00 FL00 FL00 FL00 FL00 FL00 FL00 FL00 FL00 FL00 FL00 FL00 FL00 FL00 FL00 FL00 FL00 FL00 FL00 FL00 FL00 FL00 FL00 FL00 FL00 FL00 FL00 FL00 FL00 FL00 FL00 FL00 FL00 FL00 FL00 WL00
WL00 FL00 FL00 FL00 FL00 FL00 FL00 FL00 FL00 FL00 FL00 FL00 FL00 FL00 FL00 FL00 FL00 FL00 FL00 FL00 FL00 FL00 FL00 FL00 FL00 FL00 FL00 FL00 FL00 FL00 FL00 FL00 FL00 FL00 FL00 FL00 FL00 FL00 FL00 FL00 FL00 FL00 FL00 FL00 FL00 FL00 FL00 FL00 FL00 FL00 FL00 FL00 FL00 FL00 FL00 FL00 FL00 FL00 FL00 FL00 FL00 FL00 FL00 FL00 FL00 FL00 FL00 FL00 FL00 FL00 FL00 FL00 FL00 FL00 FL00 FL00 FL00 FL00 FL00 FL00 FL00 FL00 FL00 FL00 FL00 FL00 FL00 FL00 FL00 FL00 FL00 FL00 FL00 WL00
WL00 FL00 FL00 FL00 FL00 FL00 FL00 FL00 FL00 FL00 FL00 FL00 FL00 FL00 FL00 FL00 FL00 FL00 FL00 FL00 FL00 FL00 FL00 FL00 FL00 FL00 FL00 FL00 FL00 FL00 FL00 FL00 FL00 FL00 FL00 FL00 FL00 FL00 FL00 FL00 FL00 FL00 FL00 FL00 FL00 FL00 FL00 FL00 FL00 FL00 FL00 FL00 FL00 FL00 FL00 FL00 FL00 FL00 FL00 FL00 FL00 FL00 FL00 FL00 FL00 FL00 FL00 FL00 FL00 FL00 FL00 FL00 FL00 FL00 FL00 FL00 FL00 FL00 FL00 FL00 FL00 FL00 FL00 FL00 FL00 FL00 FL00 FL00 FL00 FL00 FL00 FL00 FL00 WL00
WL00 FL00 FL00 FL00 FL00 FL00 FL00 FL00 FL00 FL00 FL00 FL00 FL00 FL00 FL00 FL00 FL00 FL00 FL00 FL00 FL00 FL00 FL00 FL00 FL00 FL00 FL00 FL00 FL00 FL00 FL00 FL00 FL00 FL00 FL00 FL00 FL00 FL00 FL00 FL00 FL00 FL00 FL00 FL00 FL00 FL00 FL00 FL00 FL00 FL00 FL00 FL00 FL00 FL00 FL00 FL00 FL00 FL00 FL00 FL00 FL00 FL00 FL00 FL00 FL00 FL00 FL00 FL00 FL00 FL00 FL00 FL00 FL00 FL00 FL00 FL00 FL00 FL00 FL00 FL00 FL00 FL00 FL00 FL00 FL00 FL00 FL00 FL00 FL00 FL00 FL00 FL00 FL00 WL00
WL00 FL00 FL00 FL00 FL00 FL00 FL00 FL00 FL00 FL00 FL00 FL00 FL00 FL00 FL00 FL00 FL00 FL00 FL00 FL00 FL00 FL00 FL00 FL00 FL00 FL00 FL00 FL00 FL00 FL00 FL00 FL00 FL00 FL00 FL00 FL00 FL00 FL00 FL00 FL00 FL00 FL00 FL00 FL00 FL00 FL00 FL00 FL00 FL00 FL00 FL00 FL00 FL00 FL00 FL00 FL00 FL00 FL00 FL00 FL00 FL00 FL00 FL00 FL00 FL00 FL00 FL00 FL00 FL00 FL00 FL00 FL00 FL00 FL00 FL00 FL00 FL00 FL00 FL00 FL00 FL00 FL00 FL00 FL00 FL00 FL00 FL00 FL00 FL00 FL00 FL00 FL00 FL00 WL00
WL00 FL00 FL00 FL00 FL00 FL00 FL00 FL00 FL00 FL00 FL00 FL00 FL00 FL00 FL00 FL00 FL00 FL00 FL00 FL00 FL00 FL00 FL00 FL00 FL00 FL00 FL00 FL00 FL00 FL00 FL00 FL00 FL00 FL00 FL00 FL00 FL00 FL00 FL00 FL00 FL00 FL00 FL00 FL00 FL00 FL00 FL00 FL00 FL00 FL00 FL00 FL00 FL00 FL00 FL00 FL00 FL00 FL00 FL00 FL00 FL00 FL00 FL00 FL00 FL00 FL00 FL00 FL00 FL00 FL00 FL00 FL00 FL00 FL00 FL00 FL00 FL00 FL00 FL00 FL00 FL00 FL00 FL00 FL00 FL00 FL00 FL00 FL00 FL00 FL00 FL00 FL00 FL00 WL00
WL00 FL00 FL00 FL00 FL00 FL00 FL00 FL00 FL00 FL00 FL00 FL00 FL00 FL00 FL00 FL00 FL00 FL00 FL00 FL00 FL00 FL00 FL00 FL00 FL00 FL00 FL00 FL00 FL00 FL00 FL00 FL00 FL00 FL00 FL00 FL00 FL00 FL00 FL00 FL00 FL00 FL00 FL00 FL00 FL00 FL00 FL00 FL00 FL00 FL00 FL00 FL00 FL00 FL00 FL00 FL00 FL00 FL00 FL00 FL00 FL00 FL00 FL00 FL00 FL00 FL00 FL00 FL00 FL00 FL00 FL00 FL00 FL00 FL00 FL00 FL00 FL00 FL00 FL00 FL00 FL00 FL00 FL00 FL00 FL00 FL00 FL00 FL00 FL00 FL00 FL00 FL00 FL00 WL00
WL00 FL00 FL00 FL00 FL00 FL00 FL00 FL00 FL00 FL00 FL00 FL00 FL00 FL00 FL00 FL00 FL00 FL00 FL00 FL00 FL00 FL00 FL00 FL00 FL00 FL00 FL00 FL00 FL00 FL00 FL00 FL00 FL00 FL00 FL00 FL00 FL00 FL00 FL00 FL00 FL00 FL00 FL00 FL00 FL00 FL00 FL00 FL00 FL00 FL00 FL00 FL00 FL00 FL00 FL00 FL00 FL00 FL00 FL00 FL00 FL00 FL00 FL00 FL00 FL00 FL00 FL00 FL00 FL00 FL00 FL00 FL00 FL00 FL00 FL00 FL00 FL00 FL00 FL00 FL00 FL00 FL00 FL00 FL00 FL00 FL00 FL00 FL00 FL00 FL00 FL00 FL00 FL00 WL00
WL00 FL00 FL00 FL00 FL00 FL00 FL00 FL00 FL00 FL00 FL00 FL00 FL00 FL00 FL00 FL00 FL00 FL00 FL00 FL00 FL00 FL00 FL00 FL00 FL00 FL00 FL00 FL00 FL00 FL00 FL00 FL00 FL00 FL00 FL00 FL00 FL00 FL00 FL00 FL00 FL00 FL00 FL00 FL00 FL00 FL00 FL00 FL00 FL00 FL00 FL00 FL00 FL00 FL00 FL00 FL00 FL00 FL00 FL00 FL00 FL00 FL00 FL00 FL00 FL00 FL00 FL00 FL00 FL00 FL00 FL00 FL00 FL00 FL00 FL00 FL00 FL00 FL00 FL00 FL00 FL00 FL00 FL00 FL00 FL00 FL00 FL00 FL00 FL00 FL00 FL00 FL00 FL00 WL00
WL00 FL00 FL00 FL00 FL00 FL00 FL00 FL00 FL00 FL00 FL00 FL00 FL00 FL00 FL00 FL00 FL00 FL00 FL00 FL00 FL00 FL00 FL00 FL00 FL00 FL00 FL00 FL00 FL00 FL00 FL00 FL00 FL00 FL00 FL00 FL00 FL00 FL00 FL00 FL00 FL00 FL00 FL00 FL00 FL00 FL00 FL00 FL00 FL00 FL00 FL00 FL00 FL00 FL00 FL00 FL00 FL00 FL00 FL00 FL00 FL00 FL00 FL00 FL00 FL00 FL00 FL00 FL00 FL00 FL00 FL00 FL00 FL00 FL00 FL00 FL00 FL00 FL00 FL00 FL00 FL00 FL00 FL00 FL00 FL00 FL00 FL00 FL00 FL00 FL00 FL00 FL00 FL00 WL00
WL00 FL00 FL00 FL00 FL00 FL00 FL00 FL00 FL00 FL00 FL00 FL00 FL00 FL00 FL00 FL00 FL00 FL00 FL00 FL00 FL00 FL00 FL00 FL00 FL00 FL00 FL00 FL00 FL00 FL00 FL00 FL00 FL00 FL00 FL00 FL00 FL00 FL00 FL00 FL00 FL00 FL00 FL00 FL00 FL00 FL00 FL00 FL00 FL00 FL00 FL00 FL00 FL00 FL00 FL00 FL00 FL00 FL00 FL00 FL00 FL00 FL00 FL00 FL00 FL00 FL00 FL00 FL00 FL00 FL00 FL00 FL00 FL00 FL00 FL00 FL00 FL00 FL00 FL00 FL00 FL00 FL00 FL00 FL00 FL00 FL00 FL00 FL00 FL00 FL00 FL00 FL00 FL00 WL00
WL00 FL00 FL00 FL00 FL00 FL00 FL00 FL00 FL00 FL00 FL00 FL00 FL00 FL00 FL00 FL00 FL00 FL00 FL00 FL00 FL00 FL00 FL00 FL00 FL00 FL00 FL00 FL00 FL00 FL00 FL00 FL00 FL00 FL00 FL00 FL00 FL00 FL00 FL00 FL00 FL00 FL00 FL00 FL00 FL00 FL00 FL00 FL00 FL00 FL00 FL00 FL00 FL00 FL00 FL00 FL00 FL00 FL00 FL00 FL00 FL00 FL00 FL00 FL00 FL00 FL00 FL00 FL00 FL00 FL00 FL00 FL00 FL00 FL00 FL00 FL00 FL00 FL00 FL00 FL00 FL00 FL00 FL00 FL00 FL00 FL00 FL00 FL00 FL00 FL00 FL00 FL00 FL00 WL00
WL00 FL00 FL00 FL00 FL00 FL00 FL00 FL00 FL00 FL00 FL00 FL00 FL00 FL00 FL00 FL00 FL00 FL00 FL00 FL00 FL00 FL00 FL00 FL00 FL00 FL00 FL00 FL00 FL00 FL00 FL00 FL00 FL00 FL00 FL00 FL00 FL00 FL00 FL00 FL00 FL00 FL00 FL00 FL00 FL00 FL00 FL00 FL00 FL00 FL00 FL00 FL00 FL00 FL00 FL00 FL00 FL00 FL00 FL00 FL00 FL00 FL00 FL00 FL00 FL00 FL00 FL00 FL00 FL00 FL00 FL00 FL00 FL00 FL00 FL00 FL00 FL00 FL00 FL00 FL00 FL00 FL00 FL00 FL00 FL00 FL00 FL00 FL00 FL00 FL00 FL00 FL00 FL00 WL00
WL00 FL00 FL00 FL00 FL00 FL00 FL00 FL00 FL00 FL00 FL00 FL00 FL00 FL00 FL00 FL00 FL00 FL00 FL00 FL00 FL00 FL00 FL00 FL00 FL00 FL00 FL00 FL00 FL00 FL00 FL00 FL00 FL00 FL00 FL00 FL00 FL00 FL00 FL00 FL00 FL00 FL00 FL00 FL00 FL00 FL00 FL00 FL00 FL00 FL00 FL00 FL00 FL00 FL00 FL00 FL00 FL00 FL00 FL00 FL00 FL00 FL00 FL00 FL00 FL00 FL00 FL00 FL00 FL00 FL00 FL00 FL00 FL00 FL00 FL00 FL00 FL00 FL00 FL00 FL00 FL00 FL00 FL00 FL00 FL00 FL00 FL00 FL00 FL00 FL00 FL00 FL00 FL00 WL00
WL00 FL00 FL00 FL00 FL00 FL00 FL00 FL00 FL00 FL00 FL00 FL00 FL00 FL00 FL00 FL00 FL00 FL00 FL00 FL00 FL00 FL00 FL00 FL00 FL00 FL00 FL00 FL00 FL00 FL00 FL00 FL00 FL00 FL00 FL00 FL00 FL00 FL00 FL00 FL00 FL00 FL00 FL00 FL00 FL00 FL00 FL00 FL00 FL00 FL00 FL00 FL00 FL00 FL00 FL00 FL00 FL00 FL00 FL00 FL00 FL00 FL00 FL00 FL00 FL00 FL00 FL00 FL00 FL00 FL00 FL00 FL00 FL00 FL00 FL00 FL00 FL00 FL00 FL00 FL00 FL00 FL00 FL00 FL00 FL00 FL00 FL00 FL00 FL00 FL00 FL00 FL00 FL00 WL00
WL00 FL00 FL00 FL00 FL00 FL00 FL00 FL00 FL00 FL00 FL00 FL00 FL00 FL00 FL00 FL00 FL00 FL00 FL00 FL00 FL00 FL00 FL00 FL00 FL00 FL00 FL00 FL00 FL00 FL00 FL00 FL00 FL00 FL00 FL00 FL00 FL00 FL00 FL00 FL00 FL00 FL00 FL00 FL00 FL00 FL00 FL00 FL00 FL00 FL00 FL00 FL00 FL00 FL00 FL00 FL00 FL00 FL00 FL00 FL00 FL00 FL00 FL00 FL00 FL00 FL00 FL00 FL00 FL00 FL00 FL00 FL00 FL00 FL00 FL00 FL00 FL00 FL00 FL00 FL00 FL00 FL00 FL00 FL00 FL00 FL00 FL00 FL00 FL00 FL00 FL00 FL00 FL00 WL00
WL00 FL00 FL00 FL00 FL00 FL00 FL00 FL00 FL00 FL00 FL00 FL00 FL00 FL00 FL00 FL00 FL00 FL00 FL00 FL00 FL00 FL00 FL00 FL00 FL00 FL00 FL00 FL00 FL00 FL00 FL00 FL00 FL00 FL00 FL00 FL00 FL00 FL00 FL00 FL00 FL00 FL00 FL00 FL00 FL00 FL00 FL00 FL00 FL00 FL00 FL00 FL00 FL00 FL00 FL00 FL00 FL00 FL00 FL00 FL00 FL00 FL00 FL00 FL00 FL00 FL00 FL00 FL00 FL00 FL00 FL00 FL00 FL00 FL00 FL00 FL00 FL00 FL00 FL00 FL00 FL00 FL00 FL00 FL00 FL00 FL00 FL00 FL00 FL00 FL00 FL00 FL00 FL00 WL00
WL00 FL00 FL00 FL00 FL00 FL00 FL00 FL00 FL00 FL00 FL00 FL00 FL00 FL00 FL00 FL00 FL00 FL00 FL00 FL00 FL00 FL00 FL00 FL00 FL00 FL00 FL00 FL00 FL00 FL00 FL00 FL00 FL00 FL00 FL00 FL00 FL00 FL00 FL00 FL00 FL00 FL00 FL00 FL00 FL00 FL00 FL00 FL00 FL00 FL00 FL00 FL00 FL00 FL00 FL00 FL00 FL00 FL00 FL00 FL00 FL00 FL00 FL00 FL00 FL00 FL00 FL00 FL00 FL00 FL00 FL00 FL00 FL00 FL00 FL00 FL00 FL00 FL00 FL00 FL00 FL00 FL00 FL00 FL00 FL00 FL00 FL00 FL00 FL00 FL00 FL00 FL00 FL00 WL00
WL00 FL00 FL00 FL00 FL00 FL00 FL00 FL00 FL00 FL00 FL00 FL00 FL00 FL00 FL00 FL00 FL00 FL00 FL00 FL00 FL00 FL00 FL00 FL00 FL00 FL00 FL00 FL00 FL00 FL00 FL00 FL00 FL00 FL00 FL00 FL00 FL00 FL00 FL00 FL00 FL00 FL00 FL00 FL00 FL00 FL00 FL00 FL00 FL00 FL00 FL00 FL00 FL00 FL00 FL00 FL00 FL00 FL00 FL00 FL00 FL00 FL00 FL00 FL00 FL00 FL00 FL00 FL00 FL00 FL00 FL00 FL00 FL00 FL00 FL00 FL00 FL00 FL00 FL00 FL00 FL00 FL00 FL00 FL00 FL00 FL00 FL00 FL00 FL00 FL00 FL00 FL00 FL00 WL00
WL00 FL00 FL00 FL00 FL00 FL00 FL00 FL00 FL00 FL00 FL00 FL00 FL00 FL00 FL00 FL00 FL00 FL00 FL00 FL00 FL00 FL00 FL00 FL00 FL00 FL00 FL00 FL00 FL00 FL00 FL00 FL00 FL00 FL00 FL00 FL00 FL00 FL00 FL00 FL00 FL00 FL00 FL00 FL00 FL00 FL00 FL00 FL00 FL00 FL00 FL00 FL00 FL00 FL00 FL00 FL00 FL00 FL00 FL00 FL00 FL00 FL00 FL00 FL00 FL00 FL00 FL00 FL00 FL00 FL00 FL00 FL00 FL00 FL00 FL00 FL00 FL00 FL00 FL00 FL00 FL00 FL00 FL00 FL00 FL00 FL00 FL00 FL00 FL00 FL00 FL00 FL00 FL00 WL00
WL00 FL00 FL00 FL00 FL00 FL00 FL00 FL00 FL00 FL00 FL00 FL00 FL00 FL00 FL00 FL00 FL00 FL00 FL00 FL00 FL00 FL00 FL00 FL00 FL00 FL00 FL00 FL00 FL00 FL00 FL00 FL00 FL00 FL00 FL00 FL00 FL00 FL00 FL00 FL00 FL00 FL00 FL00 FL00 FL00 FL00 FL00 FL00 FL00 FL00 FL00 FL00 FL00 FL00 FL00 FL00 FL00 FL00 FL00 FL00 FL00 FL00 FL00 FL00 FL00 FL00 FL00 FL00 FL00 FL00 FL00 FL00 FL00 FL00 FL00 FL00 FL00 FL00 FL00 FL00 FL00 FL00 FL00 FL00 FL00 FL00 FL00 FL00 FL00 FL00 FL00 FL00 FL00 WL00
WL00 FL00 FL00 FL00 FL00 FL00 FL00 FL00 FL00 FL00 FL00 FL00 FL00 FL00 FL00 FL00 FL00 FL00 FL00 FL00 FL00 FL00 FL00 FL00 FL00 FL00 FL00 FL00 FL00 FL00 FL00 FL00 FL00 FL00 FL00 FL00 FL00 FL00 FL00 FL00 FL00 FL00 FL00 FL00 FL00 FL00 FL00 FL00 FL00 FL00 FL00 FL00 FL00 FL00 FL00 FL00 FL00 FL00 FL00 FL00 FL00 FL00 FL00 FL00 FL00 FL00 FL00 FL00 FL00 FL00 FL00 FL00 FL00 FL00 FL00 FL00 FL00 FL00 FL00 FL00 FL00 FL00 FL00 FL00 FL00 FL00 FL00 FL00 FL00 FL00 FL00 FL00 FL00 WL00
WL00 FL00 FL00 FL00 FL00 FL00 FL00 FL00 FL00 FL00 FL00 FL00 FL00 FL00 FL00 FL00 FL00 FL00 FL00 FL00 FL00 FL00 FL00 FL00 FL00 FL00 FL00 FL00 FL00 FL00 FL00 FL00 FL00 FL00 FL00 FL00 FL00 FL00 FL00 FL00 FL00 FL00 FL00 FL00 FL00 FL00 FL00 FL00 FL00 FL00 FL00 FL00 FL00 FL00 FL00 FL00 FL00 FL00 FL00 FL00 FL00 FL00 FL00 FL00 FL00 FL00 FL00 FL00 FL00 FL00 FL00 FL00 FL00 FL00 FL00 FL00 FL00 FL00 FL00 FL00 FL00 FL00 FL00 FL00 FL00 FL00 FL00 FL00 FL00 FL00 FL00 FL00 FL00 WL00
WL00 FL00 FL00 FL00 FL00 FL00 FL00 FL00 FL00 FL00 FL00 FL00 FL00 FL00 FL00 FL00 FL00 FL00 FL00 FL00 FL00 FL00 FL00 FL00 FL00 FL00 FL00 FL00 FL00 FL00 FL00 FL00 FL00 FL00 FL00 FL00 FL00 FL00 FL00 FL00 FL00 FL00 FL00 FL00 FL00 FL00 FL00 FL00 FL00 FL00 FL00 FL00 FL00 FL00 FL00 FL00 FL00 FL00 FL00 FL00 FL00 FL00 FL00 FL00 FL00 FL00 FL00 FL00 FL00 FL00 FL00 FL00 FL00 FL00 FL00 FL00 FL00 FL00 FL00 FL00 FL00 FL00 FL00 FL00 FL00 FL00 FL00 FL00 FL00 FL00 FL00 FL00 FL00 WL00
WL00 FL00 FL00 FL00 FL00 FL00 FL00 FL00 FL00 FL00 FL00 FL00 FL00 FL00 FL00 FL00 FL00 FL00 FL00 FL00 FL00 FL00 FL00 FL00 FL00 FL00 FL00 FL00 FL00 FL00 FL00 FL00 FL00 FL00 FL00 FL00 FL00 FL00 FL00 FL00 FL00 FL00 FL00 FL00 FL00 FL00 FL00 FL00 FL00 FL00 FL00 FL00 FL00 FL00 FL00 FL00 FL00 FL00 FL00 FL00 FL00 FL00 FL00 FL00 FL00 FL00 FL00 FL00 FL00 FL00 FL00 FL00 FL00 FL00 FL00 FL00 FL00 FL00 FL00 FL00 FL00 FL00 FL00 FL00 FL00 FL00 FL00 FL00 FL00 FL00 FL00 FL00 FL00 WL00
WL00 FL00 FL00 FL00 FL00 FL00 FL00 FL00 FL00 FL00 FL00 FL00 FL00 FL00 FL00 FL00 FL00 FL00 FL00 FL00 FL00 FL00 FL00 FL00 FL00 FL00 FL00 FL00 FL00 FL00 FL00 FL00 FL00 FL00 FL00 FL00 FL00 FL00 FL00 FL00 FL00 FL00 FL00 FL00 FL00 FL00 FL00 FL00 FL00 FL00 FL00 FL00 FL00 FL00 FL00 FL00 FL00 FL00 FL00 FL00 FL00 FL00 FL00 FL00 FL00 FL00 FL00 FL00 FL00 FL00 FL00 FL00 FL00 FL00 FL00 FL00 FL00 FL00 FL00 FL00 FL00 FL00 FL00 FL00 FL00 FL00 FL00 FL00 FL00 FL00 FL00 FL00 FL00 WL00
WL00 FL00 FL00 FL00 FL00 FL00 FL00 FL00 FL00 FL00 FL00 FL00 FL00 FL00 FL00 FL00 FL00 FL00 FL00 FL00 FL00 FL00 FL00 FL00 FL00 FL00 FL00 FL00 FL00 FL00 FL00 FL00 FL00 FL00 FL00 FL00 FL00 FL00 FL00 FL00 FL00 FL00 FL00 FL00 FL00 FL00 FL00 FL00 FL00 FL00 FL00 FL00 FL00 FL00 FL00 FL00 FL00 FL00 FL00 FL00 FL00 FL00 FL00 FL00 FL00 FL00 FL00 FL00 FL00 FL00 FL00 FL00 FL00 FL00 FL00 FL00 FL00 FL00 FL00 FL00 FL00 FL00 FL00 FL00 FL00 FL00 FL00 FL00 FL00 FL00 FL00 FL00 FL00 WL00
WL00 FL00 FL00 FL00 FL00 FL00 FL00 FL00 FL00 FL00 FL00 FL00 FL00 FL00 FL00 FL00 FL00 FL00 FL00 FL00 FL00 FL00 FL00 FL00 FL00 FL00 FL00 FL00 FL00 FL00 FL00 FL00 FL00 FL00 FL00 FL00 FL00 FL00 FL00 FL00 FL00 FL00 FL00 FL00 FL00 FL00 FL00 FL00 FL00 FL00 FL00 FL00 FL00 FL00 FL00 FL00 FL00 FL00 FL00 FL00 FL00 FL00 FL00 FL00 FL00 FL00 FL00 FL00 FL00 FL00 FL00 FL00 FL00 FL00 FL00 FL00 FL00 FL00 FL00 FL00 FL00 FL00 FL00 FL00 FL00 FL00 FL00 FL00 FL00 FL00 FL00 FL00 FL00 WL00
WL00 FL00 FL00 FL00 FL00 FL00 FL00 FL00 FL00 FL00 FL00 FL00 FL00 FL00 FL00 FL00 FL00 FL00 FL00 FL00 FL00 FL00 FL00 FL00 FL00 FL00 FL00 FL00 FL00 FL00 FL00 FL00 FL00 FL00 FL00 FL00 FL00 FL00 FL00 FL00 FL00 FL00 FL00 FL00 FL00 FL00 FL00 FL00 FL00 FL00 FL00 FL00 FL00 FL00 FL00 FL00 FL00 FL00 FL00 FL00 FL00 FL00 FL00 FL00 FL00 FL00 FL00 FL00 FL00 FL00 FL00 FL00 FL00 FL00 FL00 FL00 FL00 FL00 FL00 FL00 FL00 FL00 FL00 FL00 FL00 FL00 FL00 FL00 FL00 FL00 FL00 FL00 FL00 WL00
WL00 FL00 FL00 FL00 FL00 FL00 FL00 FL00 FL00 FL00 FL00 FL00 FL00 FL00 FL00 FL00 FL00 FL00 FL00 FL00 FL00 FL00 FL00 FL00 FL00 FL00 FL00 FL00 FL00 FL00 FL00 FL00 FL00 FL00 FL00 FL00 FL00 FL00 FL00 FL00 FL00 FL00 FL00 FL00 FL00 FL00 FL00 FL00 FL00 FL00 FL00 FL00 FL00 FL00 FL00 FL00 FL00 FL00 FL00 FL00 FL00 FL00 FL00 FL00 FL00 FL00 FL00 FL00 FL00 FL00 FL00 FL00 FL00 FL00 FL00 FL00 FL00 FL00 FL00 FL00 FL00 FL00 FL00 FL00 FL00 FL00 FL00 FL00 FL00 FL00 FL00 FL00 FL00 WL00
WL00 FL00 FL00 FL00 FL00 FL00 FL00 FL00 FL00 FL00 FL00 FL00 FL00 FL00 FL00 FL00 FL00 FL00 FL00 FL00 FL00 FL00 FL00 FL00 FL00 FL00 FL00 FL00 FL00 FL00 FL00 FL00 FL00 FL00 FL00 FL00 FL00 FL00 FL00 FL00 FL00 FL00 FL00 FL00 FL00 FL00 FL00 FL00 FL00 FL00 FL00 FL00 FL00 FL00 FL00 FL00 FL00 FL00 FL00 FL00 FL00 FL00 FL00 FL00 FL00 FL00 FL00 FL00 FL00 FL00 FL00 FL00 FL00 FL00 FL00 FL00 FL00 FL00 FL00 FL00 FL00 FL00 FL00 FL00 FL00 FL00 FL00 FL00 FL00 FL00 FL00 FL00 FL00 WL00
WL00 FL00 FL00 FL00 FL00 FL00 FL00 FL00 FL00 FL00 FL00 FL00 FL00 FL00 FL00 FL00 FL00 FL00 FL00 FL00 FL00 FL00 FL00 FL00 FL00 FL00 FL00 FL00 FL00 FL00 FL00 FL00 FL00 FL00 FL00 FL00 FL00 FL00 FL00 FL00 FL00 FL00 FL00 FL00 FL00 FL00 FL00 FL00 FL00 FL00 FL00 FL00 FL00 FL00 FL00 FL00 FL00 FL00 FL00 FL00 FL00 FL00 FL00 FL00 FL00 FL00 FL00 FL00 FL00 FL00 FL00 FL00 FL00 FL00 FL00 FL00 FL00 FL00 FL00 FL00 FL00 FL00 FL00 FL00 FL00 FL00 FL00 FL00 FL00 FL00 FL00 FL00 FL00 WL00
WL00 FL00 FL00 FL00 FL00 FL00 FL00 FL00 FL00 FL00 FL00 FL00 FL00 FL00 FL00 FL00 FL00 FL00 FL00 FL00 FL00 FL00 FL00 FL00 FL00 FL00 FL00 FL00 FL00 FL00 FL00 FL00 FL00 FL00 FL00 FL00 FL00 FL00 FL00 FL00 FL00 FL00 FL00 FL00 FL00 FL00 FL00 FL00 FL00 FL00 FL00 FL00 FL00 FL00 FL00 FL00 FL00 FL00 FL00 FL00 FL00 FL00 FL00 FL00 FL00 FL00 FL00 FL00 FL00 FL00 FL00 FL00 FL00 FL00 FL00 FL00 FL00 FL00 FL00 FL00 FL00 FL00 FL00 FL00 FL00 FL00 FL00 FL00 FL00 FL00 FL00 FL00 FL00 WL00
WL00 FL00 FL00 FL00 FL00 FL00 FL00 FL00 FL00 FL00 FL00 FL00 FL00 FL00 FL00 FL00 FL00 FL00 FL00 FL00 FL00 FL00 FL00 FL00 FL00 FL00 FL00 FL00 FL00 FL00 FL00 FL00 FL00 FL00 FL00 FL00 FL00 FL00 FL00 FL00 FL00 FL00 FL00 FL00 FL00 FL00 FL00 FL00 FL00 FL00 FL00 FL00 FL00 FL00 FL00 FL00 FL00 FL00 FL00 FL00 FL00 FL00 FL00 FL00 FL00 FL00 FL00 FL00 FL00 FL00 FL00 FL00 FL00 FL00 FL00 FL00 FL00 FL00 FL00 FL00 FL00 FL00 FL00 FL00 FL00 FL00 FL00 FL00 FL00 FL00 FL00 FL00 FL00 WL00
WL00 FL00 FL00 FL00 FL00 FL00 FL00 FL00 FL00 FL00 FL00 FL00 FL00 FL00 FL00 FL00 FL00 FL00 FL00 FL00 FL00 FL00 FL00 FL00 FL00 FL00 FL00 FL00 FL00 FL00 FL00 FL00 FL00 FL00 FL00 FL00 FL00 FL00 FL00 FL00 FL00 FL00 FL00 FL00 FL00 FL00 FL00 FL00 FL00 FL00 FL00 FL00 FL00 FL00 FL00 FL00 FL00 FL00 FL00 FL00 FL00 FL00 FL00 FL00 FL00 FL00 FL00 FL00 FL00 FL00 FL00 FL00 FL00 FL00 FL00 FL00 FL00 FL00 FL00 FL00 FL00 FL00 FL00 FL00 FL00 FL00 FL00 FL00 FL00 FL00 FL00 FL00 FL00 WL00
WL00 FL00 FL00 FL00 FL00 FL00 FL00 FL00 FL00 FL00 FL00 FL00 FL00 FL00 FL00 FL00 FL00 FL00 FL00 FL00 FL00 FL00 FL00 FL00 FL00 FL00 FL00 FL00 FL00 FL00 FL00 FL00 FL00 FL00 FL00 FL00 FL00 FL00 FL00 FL00 FL00 FL00 FL00 FL00 FL00 FL00 FL00 FL00 FL00 FL00 FL00 FL00 FL00 FL00 FL00 FL00 FL00 FL00 FL00 FL00 FL00 FL00 FL00 FL00 FL00 FL00 FL00 FL00 FL00 FL00 FL00 FL00 FL00 FL00 FL00 FL00 FL00 FL00 FL00 FL00 FL00 FL00 FL00 FL00 FL00 FL00 FL00 FL00 FL00 FL00 FL00 FL00 FL00 WL00
WL00 FL00 FL00 FL00 FL00 FL00 FL00 FL00 FL00 FL00 FL00 FL00 FL00 FL00 FL00 FL00 FL00 FL00 FL00 FL00 FL00 FL00 FL00 FL00 FL00 FL00 FL00 FL00 FL00 FL00 FL00 FL00 FL00 FL00 FL00 FL00 FL00 FL00 FL00 FL00 FL00 FL00 FL00 FL00 FL00 FL00 FL00 FL00 FL00 FL00 FL00 FL00 FL00 FL00 FL00 FL00 FL00 FL00 FL00 FL00 FL00 FL00 FL00 FL00 FL00 FL00 FL00 FL00 FL00 FL00 FL00 FL00 FL00 FL00 FL00 FL00 FL00 FL00 FL00 FL00 FL00 FL00 FL00 FL00 FL00 FL00 FL00 FL00 FL00 FL00 FL00 FL00 FL00 WL00
WL00 FL00 FL00 FL00 FL00 FL00 FL00 FL00 FL00 FL00 FL00 FL00 FL00 FL00 FL00 FL00 FL00 FL00 FL00 FL00 FL00 FL00 FL00 FL00 FL00 FL00 FL00 FL00 FL00 FL00 FL00 FL00 FL00 FL00 FL00 FL00 FL00 FL00 FL00 FL00 FL00 FL00 FL00 FL00 FL00 FL00 FL00 FL00 FL00 FL00 FL00 FL00 FL00 FL00 FL00 FL00 FL00 FL00 FL00 FL00 FL00 FL00 FL00 FL00 FL00 FL00 FL00 FL00 FL00 FL00 FL00 FL00 FL00 FL00 FL00 FL00 FL00 FL00 FL00 FL00 FL00 FL00 FL00 FL00 FL00 FL00 FL00 FL00 FL00 FL00 FL00 FL00 FL00 WL00
WL00 FL00 FL00 FL00 FL00 FL00 FL00 FL00 FL00 FL00 FL00 FL00 FL00 FL00 FL00 FL00 FL00 FL00 FL00 FL00 FL00 FL00 FL00 FL00 FL00 FL00 FL00 FL00 FL00 FL00 FL00 FL00 FL00 FL00 FL00 FL00 FL00 FL00 FL00 FL00 FL00 FL00 FL00 FL00 FL00 FL00 FL00 FL00 FL00 FL00 FL00 FL00 FL00 FL00 FL00 FL00 FL00 FL00 FL00 FL00 FL00 FL00 FL00 FL00 FL00 FL00 FL00 FL00 FL00 FL00 FL00 FL00 FL00 FL00 FL00 FL00 FL00 FL00 FL00 FL00 FL00 FL00 FL00 FL00 FL00 FL00 FL00 FL00 FL00 FL00 FL00 FL00 FL00 WL00
WL00 FL00 FL00 FL00 FL00 FL00 FL00 FL00 FL00 FL00 FL00 FL00 FL00 FL00 FL00 FL00 FL00 FL00 FL00 FL00 FL00 FL00 FL00 FL00 FL00 FL00 FL00 FL00 FL00 FL00 FL00 FL00 FL00 FL00 FL00 FL00 FL00 FL00 FL00 FL00 FL00 FL00 FL00 FL00 FL00 FL00 FL00 FL00 FL00 FL00 FL00 FL00 FL00 FL00 FL00 FL00 FL00 FL00 FL00 FL00 FL00 FL00 FL00 FL00 FL00 FL00 FL00 FL00 FL00 FL00 FL00 FL00 FL00 FL00 FL00 FL00 FL00 FL00 FL00 FL00 FL00 FL00 FL00 FL00 FL00 FL00 FL00 FL00 FL00 FL00 FL00 FL00 FL00 WL00
WL00 FL00 FL00 FL00 FL00 FL00 FL00 FL00 FL00 FL00 FL00 FL00 FL00 FL00 FL00 FL00 FL00 FL00 FL00 FL00 FL00 FL00 FL00 FL00 FL00 FL00 FL00 FL00 FL00 FL00 FL00 FL00 FL00 FL00 FL00 FL00 FL00 FL00 FL00 FL00 FL00 FL00 FL00 FL00 FL00 FL00 FL00 FL00 FL00 FL00 FL00 FL00 FL00 FL00 FL00 FL00 FL00 FL00 FL00 FL00 FL00 FL00 FL00 FL00 FL00 FL00 FL00 FL00 FL00 FL00 FL00 FL00 FL00 FL00 FL00 FL00 FL00 FL00 FL00 FL00 FL00 FL00 FL00 FL00 FL00 FL00 FL00 FL00 FL00 FL00 FL00 FL00 FL00 WL00
WL00 FL00 FL00 FL00 FL00 FL00 FL00 FL00 FL00 FL00 FL00 FL00 FL00 FL00 FL00 FL00 FL00 FL00 FL00 FL00 FL00 FL00 FL00 FL00 FL00 FL00 FL00 FL00 FL00 FL00 FL00 FL00 FL00 FL00 FL00 FL00 FL00 FL00 FL00 FL00 FL00 FL00 FL00 FL00 FL00 FL00 FL00 FL00 FL00 FL00 FL00 FL00 FL00 FL00 FL00 FL00 FL00 FL00 FL00 FL00 FL00 FL00 FL00 FL00 FL00 FL00 FL00 FL00 FL00 FL00 FL00 FL00 FL00 FL00 FL00 FL00 FL00 FL00 FL00 FL00 FL00 FL00 FL00 FL00 FL00 FL00 FL00 FL00 FL00 FL00 FL00 FL00 FL00 WL00
WL00 FL00 FL00 FL00 FL00 FL00 FL00 FL00 FL00 FL00 FL00 FL00 FL00 FL00 FL00 FL00 FL00 FL00 FL00 FL00 FL00 FL00 FL00 FL00 FL00 FL00 FL00 FL00 FL00 FL00 FL00 FL00 FL00 FL00 FL00 FL00 FL00 FL00 FL00 FL00 FL00 FL00 FL00 FL00 FL00 FL00 FL00 FL00 FL00 FL00 FL00 FL00 FL00 FL00 FL00 FL00 FL00 FL00 FL00 FL00 FL00 FL00 FL00 FL00 FL00 FL00 FL00 FL00 FL00 FL00 FL00 FL00 FL00 FL00 FL00 FL00 FL00 FL00 FL00 FL00 FL00 FL00 FL00 FL00 FL00 FL00 FL00 FL00 FL00 FL00 FL00 FL00 FL00 WL00
WL00 FL00 FL00 FL00 FL00 FL00 FL00 FL00 FL00 FL00 FL00 FL00 FL00 FL00 FL00 FL00 FL00 FL00 FL00 FL00 FL00 FL00 FL00 FL00 FL00 FL00 FL00 FL00 FL00 FL00 FL00 FL00 FL00 FL00 FL00 FL00 FL00 FL00 FL00 FL00 FL00 FL00 FL00 FL00 FL00 FL00 FL00 FL00 FL00 FL00 FL00 FL00 FL00 FL00 FL00 FL00 FL00 FL00 FL00 FL00 FL00 FL00 FL00 FL00 FL00 FL00 FL00 FL00 FL00 FL00 FL00 FL00 FL00 FL00 FL00 FL00 FL00 FL00 FL00 FL00 FL00 FL00 FL00 FL00 FL00 FL00 FL00 FL00 FL00 FL00 FL00 FL00 FL00 WL00
WL00 FL00 FL00 FL00 FL00 FL00 FL00 FL00 FL00 FL00 FL00 FL00 FL00 FL00 FL00 FL00 FL00 FL00 FL00 FL00 FL00 FL00 FL00 FL00 FL00 FL00 FL00 FL00 FL00 FL00 FL00 FL00 FL00 FL00 FL00 FL00 FL00 FL00 FL00 FL00 FL00 FL00 FL00 FL00 FL00 FL00 FL00 FL00 FL00 FL00 FL00 FL00 FL00 FL00 FL00 FL00 FL00 FL00 FL00 FL00 FL00 FL00 FL00 FL00 FL00 FL00 FL00 FL00 FL00 FL00 FL00 FL00 FL00 FL00 FL00 FL00 FL00 FL00 FL00 FL00 FL00 FL00 FL00 FL00 FL00 FL00 FL00 FL00 FL00 FL00 FL00 FL00 FL00 WL00
WL00 FL00 FL00 FL00 FL00 FL00 FL00 FL00 FL00 FL00 FL00 FL00 FL00 FL00 FL00 FL00 FL00 FL00 FL00 FL00 FL00 FL00 FL00 FL00 FL00 FL00 FL00 FL00 FL00 FL00 FL00 FL00 FL00 FL00 FL00 FL00 FL00 FL00 FL00 FL00 FL00 FL00 FL00 FL00 FL00 FL00 FL00 FL00 FL00 FL00 FL00 FL00 FL00 FL00 FL00 FL00 FL00 FL00 FL00 FL00 FL00 FL00 FL00 FL00 FL00 FL00 FL00 FL00 FL00 FL00 FL00 FL00 FL00 FL00 FL00 FL00 FL00 FL00 FL00 FL00 FL00 FL00 FL00 FL00 FL00 FL00 FL00 FL00 FL00 FL00 FL00 FL00 FL00 WL00
WL00 FL00 FL00 FL00 FL00 FL00 FL00 FL00 FL00 FL00 FL00 FL00 FL00 FL00 FL00 FL00 FL00 FL00 FL00 FL00 FL00 FL00 FL00 FL00 FL00 FL00 FL00 FL00 FL00 FL00 FL00 FL00 FL00 FL00 FL00 FL00 FL00 FL00 FL00 FL00 FL00 FL00 FL00 FL00 FL00 FL00 FL00 FL00 FL00 FL00 FL00 FL00 FL00 FL00 FL00 FL00 FL00 FL00 FL00 FL00 FL00 FL00 FL00 FL00 FL00 FL00 FL00 FL00 FL00 FL00 FL00 FL00 FL00 FL00 FL00 FL00 FL00 FL00 FL00 FL00 FL00 FL00 FL00 FL00 FL00 FL00 FL00 FL00 FL00 FL00 FL00 FL00 FL00 WL00
WL00 FL00 FL00 FL00 FL00 FL00 FL00 FL00 FL00 FL00 FL00 FL00 FL00 FL00 FL00 FL00 FL00 FL00 FL00 FL00 FL00 FL00 FL00 FL00 FL00 FL00 FL00 FL00 FL00 FL00 FL00 FL00 FL00 FL00 FL00 FL00 FL00 FL00 FL00 FL00 FL00 FL00 FL00 FL00 FL00 FL00 FL00 FL00 FL00 FL00 FL00 FL00 FL00 FL00 FL00 FL00 FL00 FL00 FL00 FL00 FL00 FL00 FL00 FL00 FL00 FL00 FL00 FL00 FL00 FL00 FL00 FL00 FL00 FL00 FL00 FL00 FL00 FL00 FL00 FL00 FL00 FL00 FL00 FL00 FL00 FL00 FL00 FL00 FL00 FL00 FL00 FL00 FL00 WL00
WL00 FL00 FL00 FL00 FL00 FL00 FL00 FL00 FL00 FL00 FL00 FL00 FL00 FL00 FL00 FL00 FL00 FL00 FL00 FL00 FL00 FL00 FL00 FL00 FL00 FL00 FL00 FL00 FL00 FL00 FL00 FL00 FL00 FL00 FL00 FL00 FL00 FL00 FL00 FL00 FL00 FL00 FL00 FL00 FL00 FL00 FL00 FL00 FL00 FL00 FL00 FL00 FL00 FL00 FL00 FL00 FL00 FL00 FL00 FL00 FL00 FL00 FL00 FL00 FL00 FL00 FL00 FL00 FL00 FL00 FL00 FL00 FL00 FL00 FL00 FL00 FL00 FL00 FL00 FL00 FL00 FL00 FL00 FL00 FL00 FL00 FL00 FL00 FL00 FL00 FL00 FL00 FL00 WL00
WL00 FL00 FL00 FL00 FL00 FL00 FL00 FL00 FL00 FL00 FL00 FL00 FL00 FL00 FL00 FL00 FL00 FL00 FL00 FL00 FL00 FL00 FL00 FL00 FL00 FL00 FL00 FL00 FL00 FL00 FL00 FL00 FL00 FL00 FL00 FL00 FL00 FL00 FL00 FL00 FL00 FL00 FL00 FL00 FL00 FL00 FL00 FL00 FL00 FL00 FL00 FL00 FL00 FL00 FL00 FL00 FL00 FL00 FL00 FL00 FL00 FL00 FL00 FL00 FL00 FL00 FL00 FL00 FL00 FL00 FL00 FL00 FL00 FL00 FL00 FL00 FL00 FL00 FL00 FL00 FL00 FL00 FL00 FL00 FL00 FL00 FL00 FL00 FL00 FL00 FL00 FL00 FL00 WL00
WL00 FL00 FL00 FL00 FL00 FL00 FL00 FL00 FL00 FL00 FL00 FL00 FL00 FL00 FL00 FL00 FL00 FL00 FL00 FL00 FL00 FL00 FL00 FL00 FL00 FL00 FL00 FL00 FL00 FL00 FL00 FL00 FL00 FL00 FL00 FL00 FL00 FL00 FL00 FL00 FL00 FL00 FL00 FL00 FL00 FL00 FL00 FL00 FL00 FL00 FL00 FL00 FL00 FL00 FL00 FL00 FL00 FL00 FL00 FL00 FL00 FL00 FL00 FL00 FL00 FL00 FL00 FL00 FL00 FL00 FL00 FL00 FL00 FL00 FL00 FL00 FL00 FL00 FL00 FL00 FL00 FL00 FL00 FL00 FL00 FL00 FL00 FL00 FL00 FL00 FL00 FL00 FL00 WL00
WL00 FL00 FL00 FL00 FL00 FL00 FL00 FL00 FL00 FL00 FL00 FL00 FL00 FL00 FL00 FL00 FL00 FL00 FL00 FL00 FL00 FL00 FL00 FL00 FL00 FL00 FL00 FL00 FL00 FL00 FL00 FL00 FL00 FL00 FL00 FL00 FL00 FL00 FL00 FL00 FL00 FL00 FL00 FL00 FL00 FL00 FL00 FL00 FL00 FL00 FL00 FL00 FL00 FL00 FL00 FL00 FL00 FL00 FL00 FL00 FL00 FL00 FL00 FL00 FL00 FL00 FL00 FL00 FL00 FL00 FL00 FL00 FL00 FL00 FL00 FL00 FL00 FL00 FL00 FL00 FL00 FL00 FL00 FL00 FL00 FL00 FL00 FL00 FL00 FL00 FL00 FL00 FL00 WL00
WL00 FL00 FL00 FL00 FL00 FL00 FL00 FL00 FL00 FL00 FL00 FL00 FL00 FL00 FL00 FL00 FL00 FL00 FL00 FL00 FL00 FL00 FL00 FL00 FL00 FL00 FL00 FL00 FL00 FL00 FL00 FL00 FL00 FL00 FL00 FL00 FL00 FL00 FL00 FL00 FL00 FL00 FL00 FL00 FL00 FL00 FL00 FL00 FL00 FL00 FL00 FL00 FL00 FL00 FL00 FL00 FL00 FL00 FL00 FL00 FL00 FL00 FL00 FL00 FL00 FL00 FL00 FL00 FL00 FL00 FL00 FL00 FL00 FL00 FL00 FL00 FL00 FL00 FL00 FL00 FL00 FL00 FL00 FL00 FL00 FL00 FL00 FL00 FL00 FL00 FL00 FL00 FL00 WL00
WL00 FL00 FL00 FL00 FL00 FL00 FL00 FL00 FL00 FL00 FL00 FL00 FL00 FL00 FL00 FL00 FL00 FL00 FL00 FL00 FL00 FL00 FL00 FL00 FL00 FL00 FL00 FL00 FL00 FL00 FL00 FL00 FL00 FL00 FL00 FL00 FL00 FL00 FL00 FL00 FL00 FL00 FL00 FL00 FL00 FL00 FL00 FL00 FL00 FL00 FL00 FL00 FL00 FL00 FL00 FL00 FL00 FL00 FL00 FL00 FL00 FL00 FL00 FL00 FL00 FL00 FL00 FL00 FL00 FL00 FL00 FL00 FL00 FL00 FL00 FL00 FL00 FL00 FL00 FL00 FL00 FL00 FL00 FL00 FL00 FL00 FL00 FL00 FL00 FL00 FL00 FL00 FL00 WL00
WL00 FL00 FL00 FL00 FL00 FL00 FL00 FL00 FL00 FL00 FL00 FL00 FL00 FL00 FL00 FL00 FL00 FL00 FL00 FL00 FL00 FL00 FL00 FL00 FL00 FL00 FL00 FL00 FL00 FL00 FL00 FL00 FL00 FL00 FL00 FL00 FL00 FL00 FL00 FL00 FL00 FL00 FL00 FL00 FL00 FL00 FL00 FL00 FL00 FL00 FL00 FL00 FL00 FL00 FL00 FL00 FL00 FL00 FL00 FL00 FL00 FL00 FL00 FL00 FL00 FL00 FL00 FL00 FL00 FL00 FL00 FL00 FL00 FL00 FL00 FL00 FL00 FL00 FL00 FL00 FL00 FL00 FL00 FL00 FL00 FL00 FL00 FL00 FL00 FL00 FL00 FL00 FL00 WL00
WL00 FL00 FL00 FL00 FL00 FL00 FL00 FL00 FL00 FL00 FL00 FL00 FL00 FL00 FL00 FL00 FL00 FL00 FL00 FL00 FL00 FL00 FL00 FL00 FL00 FL00 FL00 FL00 FL00 FL00 FL00 FL00 FL00 FL00 FL00 FL00 FL00 FL00 FL00 FL00 FL00 FL00 FL00 FL00 FL00 FL00 FL00 FL00 FL00 FL00 FL00 FL00 FL00 FL00 FL00 FL00 FL00 FL00 FL00 FL00 FL00 FL00 FL00 FL00 FL00 FL00 FL00 FL00 FL00 FL00 FL00 FL00 FL00 FL00 FL00 FL00 FL00 FL00 FL00 FL00 FL00 FL00 FL00 FL00 FL00 FL00 FL00 FL00 FL00 FL00 FL00 FL00 FL00 WL00
WL00 WL00 WL00 WL00 WL00 WL00 WL00 WL00 WL00 WL00 WL00 WL00 WL00 WL00 WL00 WL00 WL00 WL00 WL00 WL00 WL00 WL00 WL00 WL00 WL00 WL00 WL00 WL00 WL00 WL00 WL00 WL00 WL00 WL00 WL00 WL00 WL00 WL00 WL00 WL00 WL00 WL00 WL00 WL00 WL00 WL00 WL00 WL00 WL00 WL00 WL00 WL00 WL00 WL00 WL00 WL00 WL00 WL00 WL00 WL00 WL00 WL00 WL00 WL00 WL00 WL00 WL00 WL00 WL00 WL00 WL00 WL00 WL00 WL00 WL00 WL00 WL00 WL00 WL00 WL00 WL00 WL00 WL00 WL00 WL00 WL00 WL00 WL00 WL00 WL00 WL00 WL00 WL00 WL00
