# Generated from /Users/janimattiellonen/Documents/Development/fog-of-war/docs/example2.png

GRID
W02 W02 W04 W00 W06 W06 W02 W04 W04 W04 W00 W02 W00 W03 W00 W01 W00 W04 W02 W02 W05 W01 W06 W05 W04 W04 W02 W03 W06 W05 W00 W05 W05 W04 W04 W00 W02 W00 W05 W06 W01 W04 W03 W03 W03 W00 W05 W01 W01 W00
W02 F01 F00 F01 F02 F01 F01 F02 F00 F00 F00 F01 F01 F01 F01 F02 F02 F01 F01 F01 F00 F02 F00 F02 F00 F01 F02 F02 F02 F02 F01 F02 F01 F00 F00 F01 F00 F00 F00 F02 F00 F02 F00 F02 F01 F00 F02 F02 F02 W03
W05 F01 F01 F02 F00 F00 F00 F02 F01 F00 F00 F00 F01 F00 F00 F02 F01 F02 F00 F01 F02 F02 F00 F01 F00 F00 F01 F02 F01 F00 F01 F00 F00 F00 F00 F00 F00 F00 F02 F00 F02 F02 F00 F00 F00 F02 F02 F01 F00 W01
W04 F02 F02 F01 F02 F02 F00 F01 F02 F00 F01 F00 F00 F00 F02 F01 F00 F02 F02 F02 F02 F01 F01 F01 F00 F00 F00 F01 F00 F01 F02 F02 F02 F02 F02 F02 F02 F02 F01 F00 F00 F00 F01 F00 F02 F01 F01 F02 F01 W04
W06 F01 F01 F00 F01 F01 F00 F01 F02 F00 F00 F01 F02 F01 F02 F00 F02 F00 F02 F02 F01 F02 F00 F02 F00 F01 F01 F02 F01 F02 F01 F01 F01 F00 F01 F00 F01 F01 F00 F02 F01 F02 F02 F00 F00 F02 F02 F00 F01 W03
W05 F00 F01 F01 F00 F02 F00 F01 F02 F01 F02 F00 F01 F02 F00 F00 F01 F00 F01 F00 F00 F00 F00 F02 F00 F00 F02 F01 F02 F02 F00 F02 F00 F00 F01 F00 F00 F01 F01 F00 F00 F02 F01 F00 F02 F00 F00 F02 F02 W06
W06 F02 F02 F00 F00 F01 F00 F01 F01 F01 F02 F01 F01 F00 F01 F01 F02 F02 F01 F00 F00 F01 F01 F02 F02 F00 F00 F02 F02 F02 F02 F02 F01 F02 F01 F02 F00 F00 F02 F01 F00 F00 F00 F00 F00 F00 F00 F00 F01 W02
W00 F01 F02 F02 F01 F02 F02 F01 F02 F00 F02 F01 F02 F02 F02 F02 F01 F00 F02 F01 F02 F00 F02 F00 F02 F01 F02 F00 F00 F00 F02 F02 F01 F02 F00 F01 F00 F02 F00 F00 F00 F01 F00 F02 F01 F02 F00 F00 F02 W02
W02 F00 F01 F00 F01 F02 F01 F00 F02 F01 F00 F02 F02 F02 F01 F02 F00 F01 F02 F02 F01 F00 F01 F02 F02 F01 F01 F01 F02 F02 F00 F01 F00 F02 F00 F02 F01 F00 F00 F02 F00 F02 F02 F01 F01 F00 F02 F00 F01 W01
W02 F02 F02 F01 F01 F02 F01 F02 F00 F00 F02 F01 F01 F00 F01 F02 F01 F02 F00 F00 F00 F02 F02 F02 F02 F01 F00 F00 F02 F01 F02 F02 F02 F02 F02 F02 F00 F00 F02 F01 F02 F00 F00 F01 F01 F01 F01 F02 F01 W05
W00 F00 F00 F01 F02 F01 F02 F00 F01 F02 F00 F00 F01 F00 F02 F02 W05 W06 W01 W06 F02 F02 F02 F01 F01 F02 F00 F01 F01 F02 W05 W03 W00 W06 F00 F02 F01 F02 F00 F02 F01 F00 F00 F01 F00 F00 F02 F00 F01 W02
W04 F02 F02 F01 F00 F00 F01 F02 F00 F01 F02 F02 F01 F00 F02 F02 W03 W00 W00 W05 F01 F02 F01 F01 F01 F01 F01 F01 F00 F01 W04 W04 W06 W03 F00 F02 F02 F02 F02 F02 F00 F02 F02 F01 F02 F01 F00 F00 F01 W04
W00 F01 F01 F00 F01 F01 F01 F00 F01 F00 F00 F00 F01 F01 F02 F00 W01 W02 W02 W01 F02 F01 F00 F01 F00 F00 F02 F01 F00 F00 W00 W02 W04 W01 F01 F01 F02 F00 F01 F00 F02 F01 F00 F00 F02 F02 F02 F02 F00 W03
W03 F00 F02 F02 F02 F00 F00 F02 F00 F01 F01 F00 F02 F02 F02 F00 W02 W01 W06 W02 F02 F00 F01 F00 F00 F02 F00 F00 F02 F00 W02 W06 W00 W00 F02 F01 F00 F01 F01 F02 F00 F00 F02 F01 F01 F02 F00 F01 F01 W04
W01 F01 F01 F02 F02 F00 F00 F01 F00 F00 F02 F01 F01 F02 F02 F00 F01 F02 F02 F02 F00 F00 F01 F01 F00 F01 F02 F00 F02 F02 F01 F00 F00 F02 F00 F00 F01 F02 F02 F01 F00 F00 F00 F00 F00 F00 F00 F00 F02 W04
W04 F00 F02 F02 F02 F02 F00 F00 F02 F00 F02 F00 F00 F01 F01 F00 F00 F00 F02 F01 F00 F02 F01 F00 F01 F01 F00 F01 F00 F01 F02 F02 F02 F02 F02 F02 F01 F00 F00 F00 F02 F00 F02 F02 F00 F00 F00 F02 F00 W01
W00 F00 F02 F00 F00 F00 F01 F01 F01 F00 F01 F01 F01 F02 F00 F00 F00 F00 F01 F02 F01 F02 F02 F01 F02 F02 F01 F01 F00 F00 F02 F02 F01 F00 F00 F00 F02 F01 F02 F01 F01 F00 F00 F01 F00 F02 F02 F00 F01 W04
W03 F02 F01 F01 F01 F00 F02 F02 F02 F02 F01 F01 F01 F00 F01 F01 F02 F02 F00 F01 F00 F01 F01 W06 W01 W02 W01 F01 F00 F01 F00 F01 F00 F01 F01 F01 F01 F02 F01 F02 F00 F00 F02 F00 F02 F00 F00 F01 F01 W03
W05 F00 F01 F01 F02 F02 F02 F02 F00 F02 F00 F00 F02 F02 F02 F02 F02 F01 F00 F00 F02 F01 F00 W06 W01 W03 W04 F00 F01 F01 F00 F00 F00 F02 F01 F01 F01 F00 F00 F00 F01 F02 F00 F02 F02 F02 F01 F00 F02 W00
W03 F02 F01 F01 F01 F01 F02 F00 F02 F00 F02 F02 F01 F01 F00 F02 F01 F01 F01 F02 F02 F02 F02 W04 W06 W02 W04 F00 F00 F00 F02 F02 F00 F02 F01 F00 F02 F01 F00 F02 F01 F02 F01 F02 F01 F01 F01 F00 F00 W03
W02 F00 F01 F02 F02 F00 F00 F02 F00 F01 F01 F00 F02 F01 F00 F01 F01 F02 F01 F00 F00 F02 F00 W04 W01 W03 W00 F00 F02 F01 F00 F02 F00 F00 F00 F01 F01 F00 F02 F01 F02 F02 F00 F02 F00 F00 F01 F01 F02 W06
W03 F02 F01 F01 F01 F00 F02 F02 F00 F00 F02 F01 F02 F02 F02 F02 F02 F02 F02 F00 F00 F02 F01 F02 F01 F01 F00 F01 F02 F00 F02 F01 F00 F00 F02 F01 F02 F00 F02 F01 F01 F01 F01 F01 F00 F02 F02 F02 F00 W04
W04 F02 F01 F00 F00 F00 F00 F02 F01 F02 F00 F00 W01 W04 W01 W01 F02 F02 F00 F01 F00 F02 F01 F01 F00 F02 F00 F01 F01 F02 F01 F01 F02 F00 W00 W04 W01 W06 F00 F02 F01 F02 F02 F01 F00 F00 F01 F00 F00 W04
W00 F02 F01 F00 F02 F00 F01 F01 F01 F02 F00 F00 W00 W04 W04 W02 F01 F02 F00 F02 F00 F00 F00 F00 F01 F00 F01 F02 F00 F01 F00 F00 F01 F01 W06 W00 W02 W03 F00 F00 F02 F02 F02 F02 F02 F01 F02 F00 F02 W01
W04 F00 F01 F01 F01 F00 F02 F02 F01 F01 F00 F00 W05 W03 W03 W01 F00 F02 F02 F02 F00 F01 F02 F01 F01 F00 F00 F00 F02 F02 F02 F02 F01 F02 W01 W00 W03 W03 F00 F01 F00 F02 F01 F02 F00 F02 F00 F02 F02 W06
W00 F02 F00 F00 F02 F01 F00 F01 F01 F02 F00 F00 W03 W02 W00 W03 F02 F00 F01 F02 F01 F00 F00 F02 F00 F01 F00 F00 F02 F02 F01 F00 F00 F01 W06 W05 W04 W06 F00 F01 F01 F00 F00 F01 F01 F00 F00 F01 F01 W05
W04 F00 F00 F01 F01 F02 F00 F00 F00 F02 F00 F01 F02 F00 F00 F02 W05 W04 W05 W03 W00 W04 W00 W05 W04 W03 W06 W05 W06 W01 W04 W03 W02 W03 F01 F01 F01 F01 F00 F00 F01 F00 F02 F01 F02 F01 F00 F00 F01 W02
W04 F01 F02 F02 F01 F02 F02 F00 F02 F01 F01 F01 F02 F02 F02 F00 W04 W00 W01 W05 W02 W00 W03 W06 W04 W05 W01 W02 W01 W05 W03 W01 W04 W06 F02 F00 F00 F01 F02 F01 F00 F01 F01 F01 F01 F00 F02 F01 F00 W02
W05 F01 F02 F02 F00 F00 F02 F02 F01 F02 F02 F00 F01 F02 F02 F00 W04 W02 W00 W06 W03 W06 W05 W04 W03 W02 W01 W06 W02 W02 W05 W06 W00 W01 F02 F01 F01 F00 F01 F01 F01 F00 F01 F02 F00 F02 F02 F00 F01 W00
W04 F00 F02 F02 F00 F00 F02 F01 F01 F00 F00 F01 F01 F02 F00 F02 W02 W01 W02 W03 W05 W05 W02 W00 W04 W01 W03 W00 W00 W02 W02 W04 W01 W05 F00 F00 F02 F01 F01 F00 F00 F02 F01 F02 F00 F01 F02 F00 F00 W05
W05 F02 F02 F01 F01 F00 F02 F00 F02 F01 F00 F00 F02 F00 F02 F00 F01 F01 F02 F00 F00 F00 F01 F01 F01 F01 F02 F01 F02 F02 F00 F00 F00 F02 F00 F02 F00 F00 F00 F00 F02 F00 F02 F01 F02 F02 F00 F02 F00 W01
W03 F01 F02 F02 F00 F00 F02 F02 F00 F02 F00 F01 F00 F00 F02 F02 F00 F01 F01 F02 F01 F00 F01 F00 F01 F02 F00 F00 F02 F01 F00 F02 F00 F00 F01 F00 F02 F00 F02 F01 F00 F00 F00 F01 F00 F00 F00 F02 F02 W01
W00 F02 F01 F01 F02 F00 F02 F01 F02 F01 F02 F01 F00 F00 F01 F01 F00 F02 F02 F00 F01 F01 F02 F02 F00 F00 F02 F01 F01 F02 F01 F01 F02 F02 F02 F00 F02 F01 F00 F02 F01 F02 F00 F00 F02 F00 F00 F00 F00 W01
W05 F01 F00 F00 F01 F01 F02 F01 F02 F02 F00 F00 F02 F00 F01 F00 F02 F01 F00 F01 F02 F02 F02 F02 F02 F00 F01 F01 F01 F02 F01 F02 F02 F00 F02 F02 F00 F00 F02 F02 F02 F02 F02 F01 F01 F00 F01 F01 F02 W05
W03 F00 F02 F02 F02 F01 F01 F00 F02 F00 F01 F00 F00 F02 F00 F02 F02 F01 F00 F01 F01 F00 F02 F01 F02 F01 F01 F00 F02 F02 F01 F00 F01 F02 F00 F02 F00 F00 F00 F02 F02 F02 F00 F01 F01 F00 F01 F02 F01 W06
W03 F02 F01 F02 F01 F02 F00 F02 F02 F02 F02 F00 F01 F01 F02 F02 F02 F01 F02 F01 F01 F00 F01 F02 F02 F02 F00 F00 F02 F00 F01 F02 F01 F00 F02 F02 F02 F01 F02 F00 F02 F02 F01 F01 F00 F02 F02 F01 F00 W00
W01 F01 F01 F01 F02 F02 F00 F00 F01 F00 F00 F00 F00 F02 F02 F01 F00 F02 F02 F01 F02 F00 F00 F01 F01 F02 F01 F02 F01 F02 F01 F01 F01 F00 F01 F01 F00 F02 F00 F01 F00 F02 F02 F01 F02 F01 F00 F00 F01 W05
W04 F01 F00 F00 F01 F02 F02 F00 F00 F01 F02 F02 F00 F00 F01 F00 F00 F01 F02 F00 F01 F00 F00 F00 F02 F00 F02 F01 F01 F01 F01 F02 F02 F00 F00 F00 F02 F01 F02 F00 F02 F00 F01 F00 F02 F00 F01 F00 F01 W02
W06 F01 F00 F02 F00 F01 F01 F02 F01 F00 F00 F02 F00 F01 F01 F02 F00 F00 F02 F00 F02 F01 F01 F01 F00 F01 F00 F00 F00 F02 F02 F02 F00 F02 F00 F02 F01 F02 F02 F01 F02 F01 F00 F02 F00 F00 F01 F00 F01 W02
W04 F00 F00 F02 F02 F01 F00 F02 F00 F02 F02 F01 F01 F00 F02 F01 F00 F02 F00 F00 F00 F00 F02 F01 F01 F02 F00 F02 F01 F00 F02 F02 F00 F00 F02 F00 F00 F00 F01 F02 F00 F00 F00 F00 F00 F00 F00 F01 F02 W06
W06 F00 F00 F02 F00 F00 F01 F00 F02 F00 F02 F02 F01 F01 F01 F01 F00 F00 F02 F02 F00 F02 F01 F02 F00 F00 F01 F00 F01 F02 F02 F01 F00 F02 F02 F01 F01 F01 F02 F01 F02 F01 F00 F00 F02 F01 F02 F01 F01 W05
W01 F02 F02 F02 F02 F00 F02 F02 F01 F02 F00 F00 F00 F00 F02 F00 F00 F02 F01 F00 F02 F01 F01 F00 F00 F02 F01 F02 F01 F01 F02 F00 F00 F02 F02 F01 F00 F01 F02 F01 F01 F02 F00 F02 F00 F02 F02 F01 F01 W02
W01 F00 F00 F01 F00 F01 F02 F02 F01 F02 F01 F00 F02 F02 F02 F02 F02 F02 F01 F02 F01 F00 F02 F02 F00 F00 F00 F02 F01 F00 F02 F00 F00 F02 F00 F02 F01 F02 F01 F01 F01 F02 F01 F02 F00 F00 F01 F01 F02 W01
W00 F00 F00 F01 F02 F00 F01 F01 F00 F02 F00 F00 F02 F01 F02 F00 F02 F00 F00 F00 F02 F02 F02 F02 F02 F01 F01 F02 F00 F01 F01 F00 F02 F00 F00 F00 F02 F01 F02 F00 F01 F00 F01 F02 F02 F01 F01 F02 F00 W00
W02 F02 F00 F01 F00 F00 F00 F01 F00 F01 F00 F01 F00 F01 F01 F01 F00 F00 F00 F01 F02 F00 F01 F00 F00 F00 F01 F00 F01 F02 F00 F00 F00 F00 F00 F01 F02 F02 F01 F00 F02 F02 F01 F02 F00 F01 F01 F02 F01 W01
W03 F00 F02 F02 F00 F00 F02 F00 F01 F00 F02 F00 F02 F02 F00 F01 F02 F00 F01 F02 F01 F01 F01 F02 F02 F02 F02 F00 F00 F01 F00 F02 F02 F01 F00 F02 F02 F00 F02 F02 F02 F00 F00 F01 F00 F00 F00 F00 F02 W06
W00 F00 F02 F01 F02 F00 F02 F02 F00 F00 F02 F02 F00 F02 F00 F02 F02 F00 F02 F01 F01 F00 F02 F01 F01 F00 F02 F00 F02 F00 F02 F01 F00 F00 F01 F01 F01 F01 F00 F00 F02 F02 F00 F00 F02 F01 F01 F02 F01 W02
W05 F00 F02 F00 F00 F00 F02 F02 F01 F01 F00 F00 F02 F01 F01 F02 F01 F01 F00 F01 F00 F00 F01 F02 F01 F02 F00 F00 F01 F00 F01 F02 F02 F02 F00 F00 F02 F01 F02 F02 F01 F00 F01 F02 F01 F00 F00 F01 F02 W01
W01 F02 F02 F00 F01 F01 F02 F02 F00 F00 F02 F00 F00 F00 F02 F00 F02 F00 F00 F00 F02 F02 F01 F01 F00 F01 F02 F00 F00 F00 F02 F02 F00 F01 F01 F00 F01 F01 F02 F02 F00 F01 F01 F00 F00 F02 F00 F02 F00 W00
W02 W03 W00 W06 W05 W00 W06 W04 W01 W05 W03 W04 W01 W05 W00 W03 W05 W03 W00 W02 W06 W04 W01 W00 W00 W02 W03 W00 W01 W06 W04 W05 W02 W05 W01 W03 W02 W02 W03 W00 W06 W03 W06 W03 W05 W00 W05 W00 W05 W01
