GRID
WL04 WL04 WL04 WL04 WL04 WL04 WL04 WL04 WL04 WL04 WL04 WL04 WL04 WL04 WL04 WL04 WL04 WL04 WL04 WL04 WL06 WL06 WL06 WL06 WL06 WL06 WL06 WL06 WL06 WL06
WL04 FL00 FL00 FL00 FL00 FL00 FL00 FL00 FL00 FL00 FL00 FL00 FL00 FL00 FL00 FL00 FL00 FL00 FL00 FL00 FL00 FL00 FL00 FL00 FL00 FL00 FL00 FL00 FL00 WL06
WL04 FL00 FL00 FL00 FL00 FL00 FL00 FL00 FL00 FL00 FL00 FL00 FL00 FL00 FL00 FL00 FL00 FL00 FL00 FL00 FL00 FL00 FL00 FL00 FL00 FL00 FL00 FL00 FL00 WL06
WL04 FL00 FL00 FL00 FL00 FL00 FL00 FL00 FL00 FL00 WL04 WL04 WL04 WL04 WL04 WL04 FL00 WL04 WL04 FL00 FL00 FL00 FL00 FL00 FL00 FL00 FL00 FL00 FL00 WL06
WL04 FL00 FL00 FL00 FL00 FL00 FL00 FL00 FL00 FL00 WL04 WL04 WL04 WL04 WL04 FL00 FL00 FL00 WL04 FL00 FL00 FL00 FL00 FL00 FL00 FL00 FL00 FL00 FL00 WL06
WL04 FL00 FL00 FL00 FL00 WL04 WL04 WL04 WL04 FL00 FL00 FL00 FL00 FL00 FL00 FL00 FL00 FL00 WL04 FL00 FL00 FL00 FL00 FL00 FL00 FL00 FL00 FL00 FL00 WL06
WL04 FL00 FL00 FL00 FL00 FL00 FL00 FL00 FL00 WL04 FL00 FL00 FL00 FL00 FL00 FL00 FL00 WL04 FL00 FL00 FL00 FL00 FL00 FL00 FL00 FL00 FL00 FL00 FL00 WL06
WL04 FL00 FL00 FL00 FL00 FL00 FL00 WL04 WL04 WL04 FL00 WL04 FL00 FL00 FL00 FL00 FL00 WL04 FL00 FL00 FL00 FL00 FL00 FL00 FL00 FL00 FL00 FL00 FL00 WL06
WL04 FL00 FL00 FL00 FL00 FL00 FL00 WL04 FL00 WL04 WL04 WL04 FL00 FL00 FL00 FL00 WL04 WL04 FL00 FL00 FL00 FL00 FL00 FL00 FL00 FL00 FL00 FL00 FL00 WL06
WL02 FL00 FL00 FL00 FL00 FL00 FL00 WL04 WL04 WL04 WL04 WL04 FL00 FL00 FL00 FL00 WL04 WL04 WL04 FL00 FL00 FL00 FL00 FL00 FL00 FL00 FL00 FL00 FL00 WL06
WL06 FL00 FL00 FL00 FL00 FL00 FL00 FL00 FL00 WL04 FL00 FL00 WL04 FL00 FL00 FL00 WL04 FL00 WL04 FL00 FL00 FL00 FL00 FL00 FL00 FL00 FL00 FL00 FL00 WL06
WL06 FL00 FL00 FL00 FL00 FL00 FL00 FL00 FL00 FL00 FL00 FL00 FL00 WL04 WL04 WL04 FL00 WL04 WL04 FL00 FL00 FL00 FL00 FL00 FL00 FL00 FL00 FL00 FL00 WL06
WL06 FL00 FL00 FL00 FL00 FL00 FL00 FL00 FL00 FL00 FL00 FL00 FL00 FL00 WL04 WL04 FL00 WL04 FL00 FL00 FL00 FL00 FL00 FL00 FL00 FL00 FL00 FL00 FL00 WL06
WL06 FL00 FL00 FL00 FL00 FL00 FL00 FL00 FL00 FL00 FL00 FL00 FL00 FL00 WL04 WL04 WL04 WL04 FL00 FL00 FL00 FL00 FL00 FL00 FL00 FL00 FL00 FL00 FL00 WL06
WL06 FL00 FL00 FL00 FL00 FL00 FL00 FL00 FL00 FL00 FL00 FL00 FL00 FL00 FL00 FL00 FL00 FL00 FL00 FL00 FL00 FL00 FL00 FL00 FL00 FL00 FL00 FL00 FL00 WL06
WL06 FL00 FL00 FL00 FL00 FL00 FL00 FL00 FL00 FL00 FL00 FL00 FL00 FL00 FL00 FL00 FL00 FL00 FL00 FL00 FL00 FL00 FL00 FL00 FL00 FL00 FL00 FL00 FL00 WL06
WL06 FL00 FL00 FL00 FL00 FL00 FL00 FL00 FL00 FL00 FL00 FL00 FL00 FL00 FL00 FL00 FL00 FL00 FL00 FL00 FL00 FL00 FL00 FL00 FL00 FL00 FL00 FL00 FL00 WL06
WL06 FL00 FL00 FL00 FL00 FL00 FL00 FL00 FL00 FL00 FL00 FL00 FL00 FL00 FL00 FL00 FL00 FL00 FL00 FL00 FL00 FL00 FL00 FL00 FL00 FL00 FL00 FL00 FL00 WL06
WL06 FL00 FL00 FL00 FL00 FL00 FL00 FL00 FL00 FL00 FL00 FL00 FL00 FL00 FL00 FL00 FL00 FL00 FL00 FL00 FL00 FL00 FL00 FL00 FL00 FL00 FL00 FL00 FL00 WL06
WL06 WL06 WL06 WL06 WL06 WL06 WL06 WL06 WL06 WL06 WL06 WL06 WL06 WL06 WL06 WL06 WL06 WL06 WL06 WL06 WL06 WL06 WL06 WL06 WL06 WL06 WL06 WL06 WL06 WL06
