# Fog of War - Demo Map
# Classes: letter:name:solid

CLASSES
F:floor:false
W:wall:true

TILES
F00:floor:floor/dirt1.png
W00:wall:wall/brick_dark2.png

GRID
W00 W00 W00 W00 W00 W00 W00 W00 W00 W00 W00 W00 W00 W00 W00 W00 W00 W00 W00 W00 W00 W00 W00 W00 W00 W00 W00 W00 W00 W00 W00 W00 W00 W00 W00 W00 W00 W00 W00 W00 W00 W00 W00 W00 W00 W00 W00 W00 W00 W00 W00 W00 W00 W00 W00 W00 W00 W00 W00 W00 W00 W00 W00 W00 W00 W00 W00 W00 W00 W00 W00 W00 W00 W00 W00 W00 W00 W00 W00 W00 W00 W00 W00 W00 W00 W00 W00 W00 W00 W00 W00 W00 W00 W00
W00 F00 F00 F00 F00 F00 F00 F00 F00 F00 F00 F00 F00 F00 F00 F00 F00 F00 F00 F00 F00 F00 F00 F00 F00 F00 F00 F00 F00 F00 F00 F00 F00 F00 F00 F00 F00 F00 F00 F00 F00 F00 F00 F00 F00 F00 F00 F00 F00 F00 F00 F00 F00 F00 F00 F00 F00 F00 F00 F00 F00 F00 F00 F00 F00 F00 F00 F00 F00 F00 F00 F00 F00 F00 F00 F00 F00 F00 F00 F00 F00 F00 F00 F00 F00 F00 F00 F00 F00 F00 F00 F00 F00 W00
W00 F00 W00 W00 W00 F00 F00 F00 F00 F00 F00 F00 F00 F00 F00 F00 F00 F00 F00 F00 F00 F00 F00 F00 F00 F00 F00 F00 F00 F00 F00 F00 F00 F00 F00 F00 F00 F00 F00 F00 F00 F00 F00 F00 F00 F00 F00 F00 F00 F00 F00 F00 F00 F00 F00 F00 F00 F00 F00 F00 F00 F00 F00 F00 F00 F00 F00 F00 F00 F00 F00 F00 F00 F00 F00 F00 F00 F00 F00 F00 F00 F00 F00 F00 F00 F00 F00 F00 F00 F00 F00 F00 F00 W00
W00 F00 W00 F00 F00 F00 F00 F00 F00 F00 F00 F00 F00 F00 F00 F00 F00 F00 F00 F00 F00 F00 F00 F00 F00 F00 F00 F00 F00 F00 F00 F00 F00 F00 F00 F00 F00 F00 F00 F00 F00 F00 F00 F00 F00 F00 F00 F00 F00 F00 F00 F00 F00 F00 F00 F00 F00 F00 F00 F00 F00 F00 F00 F00 F00 F00 F00 F00 F00 F00 F00 F00 F00 F00 F00 F00 F00 F00 F00 F00 F00 F00 F00 F00 F00 F00 F00 F00 F00 F00 F00 F00 F00 W00
W00 F00 W00 F00 F00 F00 F00 F00 F00 F00 F00 F00 F00 F00 F00 F00 F00 F00 F00 F00 F00 F00 F00 F00 F00 F00 F00 F00 F00 F00 F00 F00 F00 F00 F00 F00 F00 F00 F00 F00 F00 F00 F00 F00 F00 F00 F00 F00 F00 F00 F00 F00 F00 F00 F00 F00 F00 F00 F00 F00 F00 F00 F00 F00 F00 F00 F00 F00 F00 F00 F00 F00 F00 F00 F00 F00 F00 F00 F00 F00 F00 F00 F00 F00 F00 F00 F00 F00 F00 F00 F00 F00 F00 W00
W00 F00 W00 F00 F00 F00 F00 F00 F00 F00 F00 F00 F00 F00 F00 F00 F00 F00 F00 F00 F00 F00 F00 F00 F00 F00 F00 F00 F00 F00 F00 F00 F00 F00 F00 F00 F00 F00 F00 F00 F00 F00 F00 F00 F00 F00 F00 F00 F00 F00 F00 F00 F00 F00 F00 F00 F00 F00 F00 F00 F00 F00 F00 F00 F00 F00 F00 F00 F00 F00 F00 F00 F00 F00 F00 F00 F00 F00 F00 F00 F00 F00 F00 F00 F00 F00 F00 F00 F00 F00 F00 F00 F00 W00
W00 F00 W00 W00 W00 F00 F00 F00 F00 F00 F00 F00 F00 F00 F00 F00 F00 F00 F00 F00 F00 F00 F00 F00 F00 F00 F00 F00 F00 F00 F00 F00 F00 F00 F00 F00 F00 F00 F00 F00 F00 F00 F00 F00 F00 F00 F00 F00 F00 F00 F00 F00 F00 F00 F00 F00 F00 F00 F00 F00 F00 F00 F00 F00 F00 F00 F00 F00 F00 F00 F00 F00 F00 F00 F00 F00 F00 F00 F00 F00 F00 F00 F00 F00 F00 F00 F00 F00 F00 F00 F00 F00 F00 W00
W00 F00 F00 F00 F00 F00 F00 F00 F00 F00 F00 F00 F00 F00 F00 F00 F00 F00 F00 F00 F00 F00 F00 F00 F00 F00 F00 F00 F00 F00 F00 F00 F00 F00 F00 F00 F00 F00 F00 F00 F00 F00 F00 F00 F00 F00 F00 F00 F00 F00 F00 F00 F00 F00 F00 F00 F00 F00 F00 F00 F00 F00 F00 F00 F00 F00 F00 F00 F00 F00 F00 F00 F00 F00 F00 F00 F00 F00 F00 F00 F00 F00 F00 F00 F00 F00 F00 F00 F00 F00 F00 F00 F00 W00
W00 F00 F00 F00 F00 F00 F00 F00 F00 F00 F00 F00 F00 F00 F00 F00 F00 F00 F00 F00 F00 F00 F00 F00 F00 F00 F00 F00 F00 F00 F00 F00 F00 F00 F00 F00 F00 F00 F00 F00 F00 F00 F00 F00 F00 F00 F00 F00 F00 F00 F00 F00 F00 F00 F00 F00 F00 F00 F00 F00 F00 F00 F00 F00 F00 F00 F00 F00 F00 F00 F00 F00 F00 F00 F00 F00 F00 F00 F00 F00 F00 F00 F00 F00 F00 F00 F00 F00 F00 F00 F00 F00 F00 W00
W00 F00 F00 F00 F00 F00 F00 F00 F00 F00 F00 F00 F00 F00 F00 F00 F00 F00 F00 F00 F00 F00 F00 F00 F00 F00 F00 F00 F00 F00 F00 F00 F00 F00 F00 F00 F00 F00 F00 F00 F00 F00 F00 F00 F00 F00 F00 F00 F00 F00 F00 F00 F00 F00 F00 F00 F00 F00 F00 F00 F00 F00 F00 F00 F00 F00 F00 F00 F00 F00 F00 F00 F00 F00 F00 F00 F00 F00 F00 F00 F00 F00 F00 F00 F00 F00 F00 F00 F00 F00 F00 F00 F00 W00
W00 F00 F00 F00 F00 F00 F00 F00 F00 F00 F00 F00 F00 F00 F00 F00 F00 F00 F00 F00 F00 F00 F00 F00 F00 F00 F00 F00 F00 F00 F00 F00 F00 F00 F00 F00 F00 F00 F00 F00 F00 F00 F00 F00 F00 F00 F00 F00 F00 F00 F00 F00 F00 F00 F00 F00 F00 F00 F00 F00 F00 F00 F00 F00 F00 F00 F00 F00 F00 F00 F00 F00 F00 F00 F00 F00 F00 F00 F00 F00 F00 F00 F00 F00 F00 F00 F00 F00 F00 F00 F00 F00 F00 W00
W00 F00 F00 F00 F00 F00 F00 F00 F00 F00 F00 F00 F00 F00 F00 F00 F00 F00 F00 F00 F00 F00 F00 F00 F00 F00 F00 F00 F00 F00 F00 F00 F00 F00 F00 F00 F00 F00 F00 F00 F00 F00 F00 F00 F00 F00 F00 F00 F00 F00 F00 F00 F00 F00 F00 F00 F00 F00 F00 F00 F00 F00 F00 F00 F00 F00 F00 F00 F00 F00 F00 F00 F00 F00 F00 F00 F00 F00 F00 F00 F00 F00 F00 F00 F00 F00 F00 F00 F00 F00 F00 F00 F00 W00
W00 F00 F00 F00 F00 F00 F00 F00 F00 F00 F00 F00 F00 F00 F00 F00 F00 F00 F00 F00 F00 F00 F00 F00 F00 F00 F00 F00 F00 F00 F00 F00 F00 F00 F00 F00 F00 F00 F00 F00 F00 F00 F00 F00 F00 F00 F00 F00 F00 F00 F00 F00 F00 F00 F00 F00 F00 F00 F00 F00 F00 F00 F00 F00 F00 F00 F00 F00 F00 F00 F00 F00 F00 F00 F00 F00 F00 F00 F00 F00 F00 F00 F00 F00 F00 F00 F00 F00 F00 F00 F00 F00 F00 W00
W00 F00 F00 F00 F00 F00 F00 F00 F00 F00 F00 F00 F00 F00 F00 F00 F00 F00 F00 F00 F00 F00 F00 F00 F00 F00 F00 F00 F00 F00 F00 F00 F00 F00 F00 F00 F00 F00 F00 F00 F00 F00 F00 F00 F00 F00 F00 F00 F00 F00 F00 F00 F00 F00 F00 F00 F00 F00 F00 F00 F00 F00 F00 F00 F00 F00 F00 F00 F00 F00 F00 F00 F00 F00 F00 F00 F00 F00 F00 F00 F00 F00 F00 F00 F00 F00 F00 F00 F00 F00 F00 F00 F00 W00
W00 F00 F00 F00 F00 F00 F00 F00 F00 F00 F00 F00 F00 F00 F00 F00 F00 F00 F00 F00 F00 F00 F00 F00 F00 F00 F00 F00 F00 F00 F00 F00 F00 F00 F00 F00 F00 F00 F00 F00 F00 F00 F00 F00 F00 F00 F00 F00 F00 F00 F00 F00 F00 F00 F00 F00 F00 F00 F00 F00 F00 F00 F00 F00 F00 F00 F00 F00 F00 F00 F00 F00 F00 F00 F00 F00 F00 F00 F00 F00 F00 F00 F00 F00 F00 F00 F00 F00 F00 F00 F00 F00 F00 W00
W00 F00 F00 F00 F00 F00 F00 F00 F00 F00 F00 F00 F00 F00 F00 F00 F00 F00 F00 F00 F00 F00 F00 F00 F00 F00 F00 F00 F00 F00 F00 F00 F00 F00 F00 F00 F00 F00 F00 F00 F00 F00 F00 F00 F00 F00 F00 F00 F00 F00 F00 F00 F00 F00 F00 F00 F00 F00 F00 F00 F00 F00 F00 F00 F00 F00 F00 F00 F00 F00 F00 F00 F00 F00 F00 F00 F00 F00 F00 F00 F00 F00 F00 F00 F00 F00 F00 F00 F00 F00 F00 F00 F00 W00
W00 F00 F00 F00 F00 F00 F00 F00 F00 F00 F00 F00 F00 F00 F00 F00 F00 F00 F00 F00 F00 F00 F00 F00 F00 F00 F00 F00 F00 F00 F00 F00 F00 F00 F00 F00 F00 F00 F00 F00 F00 F00 F00 F00 F00 F00 F00 F00 F00 F00 F00 F00 F00 F00 F00 F00 F00 F00 F00 F00 F00 F00 F00 F00 F00 F00 F00 F00 F00 F00 F00 F00 F00 F00 F00 F00 F00 F00 F00 F00 F00 F00 F00 F00 F00 F00 F00 F00 F00 F00 F00 F00 F00 W00
W00 F00 F00 F00 F00 F00 F00 F00 F00 F00 F00 F00 F00 F00 F00 F00 F00 F00 F00 F00 F00 F00 F00 F00 F00 F00 F00 F00 F00 F00 F00 F00 F00 F00 F00 F00 F00 F00 F00 F00 F00 F00 F00 F00 F00 F00 F00 F00 F00 F00 F00 F00 F00 F00 F00 F00 F00 F00 F00 F00 F00 F00 F00 F00 F00 F00 F00 F00 F00 F00 F00 F00 F00 F00 F00 F00 F00 F00 F00 F00 F00 F00 F00 F00 F00 F00 F00 F00 F00 F00 F00 F00 F00 W00
W00 F00 F00 F00 F00 F00 F00 F00 F00 F00 F00 F00 F00 F00 F00 F00 F00 F00 F00 F00 F00 F00 F00 F00 F00 F00 F00 F00 F00 F00 F00 F00 F00 F00 F00 F00 F00 F00 F00 F00 F00 F00 F00 F00 F00 F00 F00 F00 F00 F00 F00 F00 F00 F00 F00 F00 F00 F00 F00 F00 F00 F00 F00 F00 F00 F00 F00 F00 F00 F00 F00 F00 F00 F00 F00 F00 F00 F00 F00 F00 F00 F00 F00 F00 F00 F00 F00 F00 F00 F00 F00 F00 F00 W00
W00 F00 F00 F00 F00 F00 F00 F00 F00 F00 F00 F00 F00 F00 F00 F00 F00 F00 F00 F00 F00 F00 F00 F00 F00 F00 F00 F00 F00 F00 F00 F00 F00 F00 F00 F00 F00 F00 F00 F00 F00 F00 F00 F00 F00 F00 F00 F00 F00 F00 F00 F00 F00 F00 F00 F00 F00 F00 F00 F00 F00 F00 F00 F00 F00 F00 F00 F00 F00 F00 F00 F00 F00 F00 F00 F00 F00 F00 F00 F00 F00 F00 F00 F00 F00 F00 F00 F00 F00 F00 F00 F00 F00 W00
W00 F00 F00 F00 F00 F00 F00 F00 F00 F00 F00 F00 F00 F00 F00 F00 F00 F00 F00 F00 F00 F00 F00 F00 F00 F00 F00 F00 F00 F00 F00 F00 F00 F00 F00 F00 F00 F00 F00 F00 F00 F00 F00 F00 F00 F00 F00 F00 F00 F00 F00 F00 F00 F00 F00 F00 F00 F00 F00 F00 F00 F00 F00 F00 F00 F00 F00 F00 F00 F00 F00 F00 F00 F00 F00 F00 F00 F00 F00 F00 F00 F00 F00 F00 F00 F00 F00 F00 F00 F00 F00 F00 F00 W00
W00 F00 F00 F00 F00 F00 F00 F00 F00 F00 F00 F00 F00 F00 F00 F00 F00 F00 F00 F00 F00 F00 F00 F00 F00 F00 F00 F00 F00 F00 F00 F00 F00 F00 F00 F00 F00 F00 F00 F00 F00 F00 F00 F00 F00 F00 F00 F00 F00 F00 F00 F00 F00 F00 F00 F00 F00 F00 F00 F00 F00 F00 F00 F00 F00 F00 F00 F00 F00 F00 F00 F00 F00 F00 F00 F00 F00 F00 F00 F00 F00 F00 F00 F00 F00 F00 F00 F00 F00 F00 F00 F00 F00 W00
W00 F00 F00 F00 F00 F00 F00 F00 F00 F00 F00 F00 F00 F00 F00 F00 F00 F00 F00 F00 F00 F00 F00 F00 F00 F00 F00 F00 F00 F00 F00 F00 F00 F00 F00 F00 F00 F00 F00 F00 F00 F00 F00 F00 F00 F00 F00 F00 F00 F00 F00 F00 F00 F00 F00 F00 F00 F00 F00 F00 F00 F00 F00 F00 F00 F00 F00 F00 F00 F00 F00 F00 F00 F00 F00 F00 F00 F00 F00 F00 F00 F00 F00 F00 F00 F00 F00 F00 F00 F00 F00 F00 F00 W00
W00 F00 F00 F00 F00 F00 F00 F00 F00 F00 F00 F00 F00 F00 F00 F00 F00 F00 F00 F00 F00 F00 F00 F00 F00 F00 F00 F00 F00 F00 F00 F00 F00 F00 F00 F00 F00 F00 F00 F00 F00 F00 F00 F00 F00 F00 F00 F00 F00 F00 F00 F00 F00 F00 F00 F00 F00 F00 F00 F00 F00 F00 F00 F00 F00 F00 F00 F00 F00 F00 F00 F00 F00 F00 F00 F00 F00 F00 F00 F00 F00 F00 F00 F00 F00 F00 F00 F00 F00 F00 F00 F00 F00 W00
W00 F00 F00 F00 F00 F00 F00 F00 F00 F00 F00 F00 F00 F00 F00 F00 F00 F00 F00 F00 F00 F00 F00 F00 F00 F00 F00 F00 F00 F00 F00 F00 F00 F00 F00 F00 F00 F00 F00 F00 F00 F00 F00 F00 F00 F00 F00 F00 F00 F00 F00 F00 F00 F00 F00 F00 F00 F00 F00 F00 F00 F00 F00 F00 F00 F00 F00 F00 F00 F00 F00 F00 F00 F00 F00 F00 F00 F00 F00 F00 F00 F00 F00 F00 F00 F00 F00 F00 F00 F00 F00 F00 F00 W00
W00 F00 F00 F00 F00 F00 F00 F00 F00 F00 F00 F00 F00 F00 F00 F00 F00 F00 F00 F00 F00 F00 F00 F00 F00 F00 F00 F00 F00 F00 F00 F00 F00 F00 F00 F00 F00 F00 F00 F00 F00 F00 F00 F00 F00 F00 F00 F00 F00 F00 F00 F00 F00 F00 F00 F00 F00 F00 F00 F00 F00 F00 F00 F00 F00 F00 F00 F00 F00 F00 F00 F00 F00 F00 F00 F00 F00 F00 F00 F00 F00 F00 F00 F00 F00 F00 F00 F00 F00 F00 F00 F00 F00 W00
W00 F00 F00 F00 F00 F00 F00 F00 F00 F00 F00 F00 F00 F00 F00 F00 F00 F00 F00 F00 F00 F00 F00 F00 F00 F00 F00 F00 F00 F00 F00 F00 F00 F00 F00 F00 F00 F00 F00 F00 F00 F00 F00 F00 F00 F00 F00 F00 F00 F00 F00 F00 F00 F00 F00 F00 F00 F00 F00 F00 F00 F00 F00 F00 F00 F00 F00 F00 F00 F00 F00 F00 F00 F00 F00 F00 F00 F00 F00 F00 F00 F00 F00 F00 F00 F00 F00 F00 F00 F00 F00 F00 F00 W00
W00 F00 F00 F00 F00 F00 F00 F00 F00 F00 F00 F00 F00 F00 F00 F00 F00 F00 F00 F00 F00 F00 F00 F00 F00 F00 F00 F00 F00 F00 F00 F00 F00 F00 F00 F00 F00 F00 F00 F00 F00 F00 F00 F00 F00 F00 F00 F00 F00 F00 F00 F00 F00 F00 F00 F00 F00 F00 F00 F00 F00 F00 F00 F00 F00 F00 F00 F00 F00 F00 F00 F00 F00 F00 F00 F00 F00 F00 F00 F00 F00 F00 F00 F00 F00 F00 F00 F00 F00 F00 F00 F00 F00 W00
W00 F00 F00 F00 F00 F00 F00 F00 F00 F00 F00 F00 F00 F00 F00 F00 F00 F00 F00 F00 F00 F00 F00 F00 F00 F00 F00 F00 F00 F00 F00 F00 F00 F00 F00 F00 F00 F00 F00 F00 F00 F00 F00 F00 F00 F00 F00 F00 F00 F00 F00 F00 F00 F00 F00 F00 F00 F00 F00 F00 F00 F00 F00 F00 F00 F00 F00 F00 F00 F00 F00 F00 F00 F00 F00 F00 F00 F00 F00 F00 F00 F00 F00 F00 F00 F00 F00 F00 F00 F00 F00 F00 F00 W00
W00 F00 F00 F00 F00 F00 F00 F00 F00 F00 F00 F00 F00 F00 F00 F00 F00 F00 F00 F00 F00 F00 F00 F00 F00 F00 F00 F00 F00 F00 F00 F00 F00 F00 F00 F00 F00 F00 F00 F00 F00 F00 F00 F00 F00 F00 F00 F00 F00 F00 F00 F00 F00 F00 F00 F00 F00 F00 F00 F00 F00 F00 F00 F00 F00 F00 F00 F00 F00 F00 F00 F00 F00 F00 F00 F00 F00 F00 F00 F00 F00 F00 F00 F00 F00 F00 F00 F00 F00 F00 F00 F00 F00 W00
W00 F00 F00 F00 F00 F00 F00 F00 F00 F00 F00 F00 F00 F00 F00 F00 F00 F00 F00 F00 F00 F00 F00 F00 F00 F00 F00 F00 F00 F00 F00 F00 F00 F00 F00 F00 F00 F00 F00 F00 F00 F00 F00 F00 F00 F00 F00 F00 F00 F00 F00 F00 F00 F00 F00 F00 F00 F00 F00 F00 F00 F00 F00 F00 F00 F00 F00 F00 F00 F00 F00 F00 F00 F00 F00 F00 F00 F00 F00 F00 F00 F00 F00 F00 F00 F00 F00 F00 F00 F00 F00 F00 F00 W00
W00 F00 F00 F00 F00 F00 F00 F00 F00 F00 F00 F00 F00 F00 F00 F00 F00 F00 F00 F00 F00 F00 F00 F00 F00 F00 F00 F00 F00 F00 F00 F00 F00 F00 F00 F00 F00 F00 F00 F00 F00 F00 F00 F00 F00 F00 F00 F00 F00 F00 F00 F00 F00 F00 F00 F00 F00 F00 F00 F00 F00 F00 F00 F00 F00 F00 F00 F00 F00 F00 F00 F00 F00 F00 F00 F00 F00 F00 F00 F00 F00 F00 F00 F00 F00 F00 F00 F00 F00 F00 F00 F00 F00 W00
W00 F00 F00 F00 F00 F00 F00 F00 F00 F00 F00 F00 F00 F00 F00 F00 F00 F00 F00 F00 F00 F00 F00 F00 F00 F00 F00 F00 F00 F00 F00 F00 F00 F00 F00 F00 F00 F00 F00 F00 F00 F00 F00 F00 F00 F00 F00 F00 F00 F00 F00 F00 F00 F00 F00 F00 F00 F00 F00 F00 F00 F00 F00 F00 F00 F00 F00 F00 F00 F00 F00 F00 F00 F00 F00 F00 F00 F00 F00 F00 F00 F00 F00 F00 F00 F00 F00 F00 F00 F00 F00 F00 F00 W00
W00 F00 F00 F00 F00 F00 F00 F00 F00 F00 F00 F00 F00 F00 F00 F00 F00 F00 F00 F00 F00 F00 F00 F00 F00 F00 F00 F00 F00 F00 F00 F00 F00 F00 F00 F00 F00 F00 F00 F00 F00 F00 F00 F00 F00 F00 F00 F00 F00 F00 F00 F00 F00 F00 F00 F00 F00 F00 F00 F00 F00 F00 F00 F00 F00 F00 F00 F00 F00 F00 F00 F00 F00 F00 F00 F00 F00 F00 F00 F00 F00 F00 F00 F00 F00 F00 F00 F00 F00 F00 F00 F00 F00 W00
W00 F00 F00 F00 F00 F00 F00 F00 F00 F00 F00 F00 F00 F00 F00 F00 F00 F00 F00 F00 F00 F00 F00 F00 F00 F00 F00 F00 F00 F00 F00 F00 F00 F00 F00 F00 F00 F00 F00 F00 F00 F00 F00 F00 F00 F00 F00 F00 F00 F00 F00 F00 F00 F00 F00 F00 F00 F00 F00 F00 F00 F00 F00 F00 F00 F00 F00 F00 F00 F00 F00 F00 F00 F00 F00 F00 F00 F00 F00 F00 F00 F00 F00 F00 F00 F00 F00 F00 F00 F00 F00 F00 F00 W00
W00 F00 F00 F00 F00 F00 F00 F00 F00 F00 F00 F00 F00 F00 F00 F00 F00 F00 F00 F00 F00 F00 F00 F00 F00 F00 F00 F00 F00 F00 F00 F00 F00 F00 F00 F00 F00 F00 F00 F00 F00 F00 F00 F00 F00 F00 F00 F00 F00 F00 F00 F00 F00 F00 F00 F00 F00 F00 F00 F00 F00 F00 F00 F00 F00 F00 F00 F00 F00 F00 F00 F00 F00 F00 F00 F00 F00 F00 F00 F00 F00 F00 F00 F00 F00 F00 F00 F00 F00 F00 F00 F00 F00 W00
W00 F00 F00 F00 F00 F00 F00 F00 F00 F00 F00 F00 F00 F00 F00 F00 F00 F00 F00 F00 F00 F00 F00 F00 F00 F00 F00 F00 F00 F00 F00 F00 F00 F00 F00 F00 F00 F00 F00 F00 F00 F00 F00 F00 F00 F00 F00 F00 F00 F00 F00 F00 F00 F00 F00 F00 F00 F00 F00 F00 F00 F00 F00 F00 F00 F00 F00 F00 F00 F00 F00 F00 F00 F00 F00 F00 F00 F00 F00 F00 F00 F00 F00 F00 F00 F00 F00 F00 F00 F00 F00 F00 F00 W00
W00 F00 F00 F00 F00 F00 F00 F00 F00 F00 F00 F00 F00 F00 F00 F00 F00 F00 F00 F00 F00 F00 F00 F00 F00 F00 F00 F00 F00 F00 F00 F00 F00 F00 F00 F00 F00 F00 F00 F00 F00 F00 F00 F00 F00 F00 F00 F00 F00 F00 F00 F00 F00 F00 F00 F00 F00 F00 F00 F00 F00 F00 F00 F00 F00 F00 F00 F00 F00 F00 F00 F00 F00 F00 F00 F00 F00 F00 F00 F00 F00 F00 F00 F00 F00 F00 F00 F00 F00 F00 F00 F00 F00 W00
W00 F00 F00 F00 F00 F00 F00 F00 F00 F00 F00 F00 F00 F00 F00 F00 F00 F00 F00 F00 F00 F00 F00 F00 F00 F00 F00 F00 F00 F00 F00 F00 F00 F00 F00 F00 F00 F00 F00 F00 F00 F00 F00 F00 F00 F00 F00 F00 F00 F00 F00 F00 F00 F00 F00 F00 F00 F00 F00 F00 F00 F00 F00 F00 F00 F00 F00 F00 F00 F00 F00 F00 F00 F00 F00 F00 F00 F00 F00 F00 F00 F00 F00 F00 F00 F00 F00 F00 F00 F00 F00 F00 F00 W00
W00 F00 F00 F00 F00 F00 F00 F00 F00 F00 F00 F00 F00 F00 F00 F00 F00 F00 F00 F00 F00 F00 F00 F00 F00 F00 F00 F00 F00 F00 F00 F00 F00 F00 F00 F00 F00 F00 F00 F00 F00 F00 F00 F00 F00 F00 F00 F00 F00 F00 F00 F00 F00 F00 F00 F00 F00 F00 F00 F00 F00 F00 F00 F00 F00 F00 F00 F00 F00 F00 F00 F00 F00 F00 F00 F00 F00 F00 F00 F00 F00 F00 F00 F00 F00 F00 F00 F00 F00 F00 F00 F00 F00 W00
W00 F00 F00 F00 F00 F00 F00 F00 F00 F00 F00 F00 F00 F00 F00 F00 F00 F00 F00 F00 F00 F00 F00 F00 F00 F00 F00 F00 F00 F00 F00 F00 F00 F00 F00 F00 F00 F00 F00 F00 F00 F00 F00 F00 F00 F00 F00 F00 F00 F00 F00 F00 F00 F00 F00 F00 F00 F00 F00 F00 F00 F00 F00 F00 F00 F00 F00 F00 F00 F00 F00 F00 F00 F00 F00 F00 F00 F00 F00 F00 F00 F00 F00 F00 F00 F00 F00 F00 F00 F00 F00 F00 F00 W00
W00 F00 F00 F00 F00 F00 F00 F00 F00 F00 F00 F00 F00 F00 F00 F00 F00 F00 F00 F00 F00 F00 F00 F00 F00 F00 F00 F00 F00 F00 F00 F00 F00 F00 F00 F00 F00 F00 F00 F00 F00 F00 F00 F00 F00 F00 F00 F00 F00 F00 F00 F00 F00 F00 F00 F00 F00 F00 F00 F00 F00 F00 F00 F00 F00 F00 F00 F00 F00 F00 F00 F00 F00 F00 F00 F00 F00 F00 F00 F00 F00 F00 F00 F00 F00 F00 F00 F00 F00 F00 F00 F00 F00 W00
W00 F00 F00 F00 F00 F00 F00 F00 F00 F00 F00 F00 F00 F00 F00 F00 F00 F00 F00 F00 F00 F00 F00 F00 F00 F00 F00 F00 F00 F00 F00 F00 F00 F00 F00 F00 F00 F00 F00 F00 F00 F00 F00 F00 F00 F00 F00 F00 F00 F00 F00 F00 F00 F00 F00 F00 F00 F00 F00 F00 F00 F00 F00 F00 F00 F00 F00 F00 F00 F00 F00 F00 F00 F00 F00 F00 F00 F00 F00 F00 F00 F00 F00 F00 F00 F00 F00 F00 F00 F00 F00 F00 F00 W00
W00 F00 F00 F00 F00 F00 F00 F00 F00 F00 F00 F00 F00 F00 F00 F00 F00 F00 F00 F00 F00 F00 F00 F00 F00 F00 F00 F00 F00 F00 F00 F00 F00 F00 F00 F00 F00 F00 F00 F00 F00 F00 F00 F00 F00 F00 F00 F00 F00 F00 F00 F00 F00 F00 F00 F00 F00 F00 F00 F00 F00 F00 F00 F00 F00 F00 F00 F00 F00 F00 F00 F00 F00 F00 F00 F00 F00 F00 F00 F00 F00 F00 F00 F00 F00 F00 F00 F00 F00 F00 F00 F00 F00 W00
W00 F00 F00 F00 F00 F00 F00 F00 F00 F00 F00 F00 F00 F00 F00 F00 F00 F00 F00 F00 F00 F00 F00 F00 F00 F00 F00 F00 F00 F00 F00 F00 F00 F00 F00 F00 F00 F00 F00 F00 F00 F00 F00 F00 F00 F00 F00 F00 F00 F00 F00 F00 F00 F00 F00 F00 F00 F00 F00 F00 F00 F00 F00 F00 F00 F00 F00 F00 F00 F00 F00 F00 F00 F00 F00 F00 F00 F00 F00 F00 F00 F00 F00 F00 F00 F00 F00 F00 F00 F00 F00 F00 F00 W00
W00 F00 F00 F00 F00 F00 F00 F00 F00 F00 F00 F00 F00 F00 F00 F00 F00 F00 F00 F00 F00 F00 F00 F00 F00 F00 F00 F00 F00 F00 F00 F00 F00 F00 F00 F00 F00 F00 F00 F00 F00 F00 F00 F00 F00 F00 F00 F00 F00 F00 F00 F00 F00 F00 F00 F00 F00 F00 F00 F00 F00 F00 F00 F00 F00 F00 F00 F00 F00 F00 F00 F00 F00 F00 F00 F00 F00 F00 F00 F00 F00 F00 F00 F00 F00 F00 F00 F00 F00 F00 F00 F00 F00 W00
W00 F00 F00 F00 F00 F00 F00 F00 F00 F00 F00 F00 F00 F00 F00 F00 F00 F00 F00 F00 F00 F00 F00 F00 F00 F00 F00 F00 F00 F00 F00 F00 F00 F00 F00 F00 F00 F00 F00 F00 F00 F00 F00 F00 F00 F00 F00 F00 F00 F00 F00 F00 F00 F00 F00 F00 F00 F00 F00 F00 F00 F00 F00 F00 F00 F00 F00 F00 F00 F00 F00 F00 F00 F00 F00 F00 F00 F00 F00 F00 F00 F00 F00 F00 F00 F00 F00 F00 F00 F00 F00 F00 F00 W00
W00 F00 F00 F00 F00 F00 F00 F00 F00 F00 F00 F00 F00 F00 F00 F00 F00 F00 F00 F00 F00 F00 F00 F00 F00 F00 F00 F00 F00 F00 F00 F00 F00 F00 F00 F00 F00 F00 F00 F00 F00 F00 F00 F00 F00 F00 F00 F00 F00 F00 F00 F00 F00 F00 F00 F00 F00 F00 F00 F00 F00 F00 F00 F00 F00 F00 F00 F00 F00 F00 F00 F00 F00 F00 F00 F00 F00 F00 F00 F00 F00 F00 F00 F00 F00 F00 F00 F00 F00 F00 F00 F00 F00 W00
W00 F00 F00 F00 F00 F00 F00 F00 F00 F00 F00 F00 F00 F00 F00 F00 F00 F00 F00 F00 F00 F00 F00 F00 F00 F00 F00 F00 F00 F00 F00 F00 F00 F00 F00 F00 F00 F00 F00 F00 F00 F00 F00 F00 F00 F00 F00 F00 F00 F00 F00 F00 F00 F00 F00 F00 F00 F00 F00 F00 F00 F00 F00 F00 F00 F00 F00 F00 F00 F00 F00 F00 F00 F00 F00 F00 F00 F00 F00 F00 F00 F00 F00 F00 F00 F00 F00 F00 F00 F00 F00 F00 F00 W00
W00 F00 F00 F00 F00 F00 F00 F00 F00 F00 F00 F00 F00 F00 F00 F00 F00 F00 F00 F00 F00 F00 F00 F00 F00 F00 F00 F00 F00 F00 F00 F00 F00 F00 F00 F00 F00 F00 F00 F00 F00 F00 F00 F00 F00 F00 F00 F00 F00 F00 F00 F00 F00 F00 F00 F00 F00 F00 F00 F00 F00 F00 F00 F00 F00 F00 F00 F00 F00 F00 F00 F00 F00 F00 F00 F00 F00 F00 F00 F00 F00 F00 F00 F00 F00 F00 F00 F00 F00 F00 F00 F00 F00 W00
W00 F00 F00 F00 F00 F00 F00 F00 F00 F00 F00 F00 F00 F00 F00 F00 F00 F00 F00 F00 F00 F00 F00 F00 F00 F00 F00 F00 F00 F00 F00 F00 F00 F00 F00 F00 F00 F00 F00 F00 F00 F00 F00 F00 F00 F00 F00 F00 F00 F00 F00 F00 F00 F00 F00 F00 F00 F00 F00 F00 F00 F00 F00 F00 F00 F00 F00 F00 F00 F00 F00 F00 F00 F00 F00 F00 F00 F00 F00 F00 F00 F00 F00 F00 F00 F00 F00 F00 F00 F00 F00 F00 F00 W00
W00 F00 F00 F00 F00 F00 F00 F00 F00 F00 F00 F00 F00 F00 F00 F00 F00 F00 F00 F00 F00 F00 F00 F00 F00 F00 F00 F00 F00 F00 F00 F00 F00 F00 F00 F00 F00 F00 F00 F00 F00 F00 F00 F00 F00 F00 F00 F00 F00 F00 F00 F00 F00 F00 F00 F00 F00 F00 F00 F00 F00 F00 F00 F00 F00 F00 F00 F00 F00 F00 F00 F00 F00 F00 F00 F00 F00 F00 F00 F00 F00 F00 F00 F00 F00 F00 F00 F00 F00 F00 F00 F00 F00 W00
W00 F00 F00 F00 F00 F00 F00 F00 F00 F00 F00 F00 F00 F00 F00 F00 F00 F00 F00 F00 F00 F00 F00 F00 F00 F00 F00 F00 F00 F00 F00 F00 F00 F00 F00 F00 F00 F00 F00 F00 F00 F00 F00 F00 F00 F00 F00 F00 F00 F00 F00 F00 F00 F00 F00 F00 F00 F00 F00 F00 F00 F00 F00 F00 F00 F00 F00 F00 F00 F00 F00 F00 F00 F00 F00 F00 F00 F00 F00 F00 F00 F00 F00 F00 F00 F00 F00 F00 F00 F00 F00 F00 F00 W00
W00 F00 F00 F00 F00 F00 F00 F00 F00 F00 F00 F00 F00 F00 F00 F00 F00 F00 F00 F00 F00 F00 F00 F00 F00 F00 F00 F00 F00 F00 F00 F00 F00 F00 F00 F00 F00 F00 F00 F00 F00 F00 F00 F00 F00 F00 F00 F00 F00 F00 F00 F00 F00 F00 F00 F00 F00 F00 F00 F00 F00 F00 F00 F00 F00 F00 F00 F00 F00 F00 F00 F00 F00 F00 F00 F00 F00 F00 F00 F00 F00 F00 F00 F00 F00 F00 F00 F00 F00 F00 F00 F00 F00 W00
W00 F00 F00 F00 F00 F00 F00 F00 F00 F00 F00 F00 F00 F00 F00 F00 F00 F00 F00 F00 F00 F00 F00 F00 F00 F00 F00 F00 F00 F00 F00 F00 F00 F00 F00 F00 F00 F00 F00 F00 F00 F00 F00 F00 F00 F00 F00 F00 F00 F00 F00 F00 F00 F00 F00 F00 F00 F00 F00 F00 F00 F00 F00 F00 F00 F00 F00 F00 F00 F00 F00 F00 F00 F00 F00 F00 F00 F00 F00 F00 F00 F00 F00 F00 F00 F00 F00 F00 F00 F00 F00 F00 F00 W00
W00 F00 F00 F00 F00 F00 F00 F00 F00 F00 F00 F00 F00 F00 F00 F00 F00 F00 F00 F00 F00 F00 F00 F00 F00 F00 F00 F00 F00 F00 F00 F00 F00 F00 F00 F00 F00 F00 F00 F00 F00 F00 F00 F00 F00 F00 F00 F00 F00 F00 F00 F00 F00 F00 F00 F00 F00 F00 F00 F00 F00 F00 F00 F00 F00 F00 F00 F00 F00 F00 F00 F00 F00 F00 F00 F00 F00 F00 F00 F00 F00 F00 F00 F00 F00 F00 F00 F00 F00 F00 F00 F00 F00 W00
W00 F00 F00 F00 F00 F00 F00 F00 F00 F00 F00 F00 F00 F00 F00 F00 F00 F00 F00 F00 F00 F00 F00 F00 F00 F00 F00 F00 F00 F00 F00 F00 F00 F00 F00 F00 F00 F00 F00 F00 F00 F00 F00 F00 F00 F00 F00 F00 F00 F00 F00 F00 F00 F00 F00 F00 F00 F00 F00 F00 F00 F00 F00 F00 F00 F00 F00 F00 F00 F00 F00 F00 F00 F00 F00 F00 F00 F00 F00 F00 F00 F00 F00 F00 F00 F00 F00 F00 F00 F00 F00 F00 F00 W00
W00 F00 F00 F00 F00 F00 F00 F00 F00 F00 F00 F00 F00 F00 F00 F00 F00 F00 F00 F00 F00 F00 F00 F00 F00 F00 F00 F00 F00 F00 F00 F00 F00 F00 F00 F00 F00 F00 F00 F00 F00 F00 F00 F00 F00 F00 F00 F00 F00 F00 F00 F00 F00 F00 F00 F00 F00 F00 F00 F00 F00 F00 F00 F00 F00 F00 F00 F00 F00 F00 F00 F00 F00 F00 F00 F00 F00 F00 F00 F00 F00 F00 F00 F00 F00 F00 F00 F00 F00 F00 F00 F00 F00 W00
W00 F00 F00 F00 F00 F00 F00 F00 F00 F00 F00 F00 F00 F00 F00 F00 F00 F00 F00 F00 F00 F00 F00 F00 F00 F00 F00 F00 F00 F00 F00 F00 F00 F00 F00 F00 F00 F00 F00 F00 F00 F00 F00 F00 F00 F00 F00 F00 F00 F00 F00 F00 F00 F00 F00 F00 F00 F00 F00 F00 F00 F00 F00 F00 F00 F00 F00 F00 F00 F00 F00 F00 F00 F00 F00 F00 F00 F00 F00 F00 F00 F00 F00 F00 F00 F00 F00 F00 F00 F00 F00 F00 F00 W00
W00 F00 F00 F00 F00 F00 F00 F00 F00 F00 F00 F00 F00 F00 F00 F00 F00 F00 F00 F00 F00 F00 F00 F00 F00 F00 F00 F00 F00 F00 F00 F00 F00 F00 F00 F00 F00 F00 F00 F00 F00 F00 F00 F00 F00 F00 F00 F00 F00 F00 F00 F00 F00 F00 F00 F00 F00 F00 F00 F00 F00 F00 F00 F00 F00 F00 F00 F00 F00 F00 F00 F00 F00 F00 F00 F00 F00 F00 F00 F00 F00 F00 F00 F00 F00 F00 F00 F00 F00 F00 F00 F00 F00 W00
W00 F00 F00 F00 F00 F00 F00 F00 F00 F00 F00 F00 F00 F00 F00 F00 F00 F00 F00 F00 F00 F00 F00 F00 F00 F00 F00 F00 F00 F00 F00 F00 F00 F00 F00 F00 F00 F00 F00 F00 F00 F00 F00 F00 F00 F00 F00 F00 F00 F00 F00 F00 F00 F00 F00 F00 F00 F00 F00 F00 F00 F00 F00 F00 F00 F00 F00 F00 F00 F00 F00 F00 F00 F00 F00 F00 F00 F00 F00 F00 F00 F00 F00 F00 F00 F00 F00 F00 F00 F00 F00 F00 F00 W00
W00 F00 F00 F00 F00 F00 F00 F00 F00 F00 F00 F00 F00 F00 F00 F00 F00 F00 F00 F00 F00 F00 F00 F00 F00 F00 F00 F00 F00 F00 F00 F00 F00 F00 F00 F00 F00 F00 F00 F00 F00 F00 F00 F00 F00 F00 F00 F00 F00 F00 F00 F00 F00 F00 F00 F00 F00 F00 F00 F00 F00 F00 F00 F00 F00 F00 F00 F00 F00 F00 F00 F00 F00 F00 F00 F00 F00 F00 F00 F00 F00 F00 F00 F00 F00 F00 F00 F00 F00 F00 F00 F00 F00 W00
W00 W00 W00 W00 W00 W00 W00 W00 W00 W00 W00 W00 W00 W00 W00 W00 W00 W00 W00 W00 W00 W00 W00 W00 W00 W00 W00 W00 W00 W00 W00 W00 W00 W00 W00 W00 W00 W00 W00 W00 W00 W00 W00 W00 W00 W00 W00 W00 W00 W00 W00 W00 W00 W00 W00 W00 W00 W00 W00 W00 W00 W00 W00 W00 W00 W00 W00 W00 W00 W00 W00 W00 W00 W00 W00 W00 W00 W00 W00 W00 W00 W00 W00 W00 W00 W00 W00 W00 W00 W00 W00 W00 W00 W00
