GRID
WL01 WL01 WL01 WL01 WL01 WL01 WL01 WL01 WL01 WL01 WL01 WL01 WL01 WL01 WL01 WL01 WL01 WL01 WL01 WL01 WL01 WL01 WL01 WL01 WL01 WL01 WL01 WL01 WL01 WL01 WL01 WL01 WL01 WL01 WL01 WL01 WL01 WL01 WL01 WL01 WL01 WL01 WL01 WL01 WL01 WL01 WL01 WL01 WL01 WL01 WL01 WL01 WL01 WL01 WL01 WL01 WL01 WL01 WL01 WL01
WL01 FL00 FL00 FL00 FL00 FL00 FL00 FL00 FL00 FL00 FL00 FL00 FL00 FL00 FL00 FL00 FL00 FL00 FL00 FL00 FL00 FL00 FL00 FL00 FL00 FL00 FL00 FL00 FL00 FL00 FL00 FL00 FL00 FL00 FL00 FL00 FL00 FL00 FL00 FL00 FL00 FL00 FL00 FL00 FL00 FL00 FL00 FL00 FL00 FL00 FL00 FL00 FL00 FL00 FL00 FL00 FL00 FL00 FL00 WL01
WL01 FL00 FL00 FL00 FL00 FL00 FL00 FL00 FL00 FL00 FL00 FL00 FL00 FL00 FL00 FL00 FL00 FL00 FL00 FL00 FL00 FL00 FL00 WL04 WL04 WL04 WL04 WL04 WL04 WL04 FL00 FL00 FL00 FL00 FL00 FL00 FL00 FL00 FL00 FL00 FL00 FL00 FL00 FL00 FL00 FL00 FL00 FL00 FL00 FL00 FL00 FL00 FL00 FL00 FL00 FL00 FL00 FL00 FL00 WL01
WL01 FL00 FL00 FL00 FL00 FL00 FL00 FL00 FL00 FL00 FL00 FL00 FL00 FL00 FL00 FL00 FL00 FL00 FL00 FL00 WL04 WL04 WL04 WL04 FL00 FL00 FL00 FL00 FL00 FL00 FL00 FL00 FL00 FL00 FL00 FL00 FL00 FL00 FL00 FL00 FL00 FL00 FL00 FL00 FL00 FL00 FL00 FL00 FL00 FL00 FL00 FL00 FL00 FL00 FL00 FL00 FL00 FL00 FL00 WL01
WL01 FL00 FL00 FL00 FL00 FL00 FL00 FL00 FL00 FL00 FL00 FL00 FL00 FL00 FL00 FL00 FL00 FL00 FL00 WL04 WL04 FL00 FL00 FL00 FL00 FL00 FL00 FL00 FL00 FL00 FL00 FL00 FL00 FL00 FL00 FL00 FL00 FL00 FL00 FL00 FL00 FL00 FL00 FL00 FL00 FL00 FL00 FL00 FL00 FL00 FL00 FL00 FL00 FL00 FL00 FL00 FL00 FL00 FL00 WL01
WL01 FL00 FL00 FL00 FL00 FL00 FL00 FL00 FL00 FL00 FL00 FL00 FL00 FL00 FL00 FL00 FL00 FL00 FL00 WL04 FL00 FL00 FL00 FL00 FL00 FL00 FL00 FL00 FL00 FL00 FL00 FL00 FL00 FL00 FL00 FL00 FL00 FL00 FL00 FL00 FL00 FL00 FL00 FL00 FL00 FL00 FL00 FL00 FL00 FL00 FL00 FL00 FL00 FL00 FL00 FL00 FL00 FL00 FL00 WL01
WL01 FL00 FL00 FL00 FL00 FL00 FL00 FL00 FL00 FL00 FL00 FL00 FL23 FL23 FL00 FL00 FL00 FL00 WL04 FL00 FL00 FL00 FL00 FL00 FL00 FL00 FL00 FL00 FL00 FL00 FL00 FL00 FL00 FL00 FL00 FL00 FL00 FL00 FL00 FL00 FL00 FL00 FL00 FL00 FL00 FL00 FL00 FL00 FL00 FL00 FL00 FL00 FL00 FL00 FL00 FL00 FL00 FL00 FL00 WL01
WL01 FL00 FL00 FL00 FL00 FL00 FL00 FL00 FL00 FL23 FL23 FL00 FL23 FL23 FL00 FL00 FL00 WL04 WL04 FL00 FL00 FL00 FL00 FL00 FL00 FL00 FL00 FL00 FL00 FL00 FL00 FL00 FL00 FL00 FL00 FL00 FL00 FL00 FL00 FL00 FL00 FL00 FL00 FL00 FL00 FL00 FL00 FL00 FL00 FL00 FL00 FL00 FL00 FL00 FL00 FL00 FL00 FL00 FL00 WL01
WL01 FL00 FL00 FL00 FL00 FL00 FL00 FL00 FL00 FL00 FL23 FL23 FL23 FL00 FL00 FL00 FL00 WL04 FL00 FL00 FL00 WL04 FL00 FL00 FL00 FL00 FL00 FL00 FL00 FL00 FL00 FL00 FL00 FL00 FL00 FL00 FL00 FL00 FL00 FL00 FL00 FL00 FL00 FL00 FL00 FL00 FL00 FL00 FL00 FL00 FL00 FL00 FL00 FL00 FL00 FL00 FL00 FL00 FL00 WL01
WL01 FL00 FL00 WL01 FL00 FL00 FL00 FL00 FL00 FL00 FL00 FL00 FL00 FL00 FL00 FL00 FL00 WL04 FL00 FL00 FL00 WL04 FL00 FL00 FL00 FL00 FL00 FL00 FL00 FL00 FL00 FL00 FL00 FL00 FL00 FL00 FL00 FL00 FL00 FL00 FL00 FL00 FL00 FL00 FL00 FL00 FL00 FL00 FL00 FL00 FL00 FL00 FL00 FL00 FL00 FL00 FL00 FL00 FL00 WL01
WL01 FL00 FL00 WL01 FL00 FL00 FL00 FL00 FL00 FL00 FL00 FL00 FL00 FL00 FL00 FL00 WL04 FL00 FL00 FL00 FL00 WL04 WL04 FL00 FL00 FL00 FL00 FL00 FL00 FL00 FL00 FL00 FL00 FL00 FL00 FL00 FL00 FL00 FL00 FL00 FL00 FL00 FL00 FL00 FL00 FL00 FL00 FL00 FL00 FL00 FL00 FL00 FL00 FL00 FL00 FL00 FL00 FL00 FL00 WL01
WL01 FL00 FL00 WL01 FL00 FL00 FL00 FL00 FL00 FL00 FL00 FL00 FL00 FL00 FL00 WL04 WL04 FL00 FL00 FL00 FL00 FL00 FL00 WL04 WL04 FL00 FL00 FL00 FL00 FL00 FL00 FL00 FL00 FL00 FL00 FL00 FL00 FL00 FL00 FL00 FL00 FL00 FL00 FL00 FL00 FL00 FL00 FL00 FL00 FL00 FL00 FL00 FL00 FL00 FL00 FL00 FL00 FL00 FL00 WL01
WL01 FL00 FL00 WL01 FL00 FL00 WL01 WL01 WL01 WL01 FL00 FL00 FL00 FL00 FL00 WL04 FL00 FL00 FL00 FL00 FL00 FL00 FL00 FL00 WL04 WL04 FL00 FL00 FL00 FL00 FL00 FL00 FL00 FL00 FL00 FL00 FL00 FL00 FL00 FL00 FL00 FL00 FL00 FL00 FL00 FL00 FL00 FL00 FL00 FL00 FL00 FL00 FL00 FL00 FL00 FL00 FL00 FL00 FL00 WL01
WL01 FL00 FL00 WL01 WL01 WL01 WL01 FL00 FL00 FL00 FL00 FL00 FL00 FL00 FL00 WL04 FL00 FL00 FL00 FL00 FL00 FL00 FL00 FL00 FL00 WL04 FL00 FL00 FL00 FL00 FL00 FL00 FL00 FL00 FL00 FL00 FL00 FL00 FL00 FL00 FL00 FL00 FL00 FL00 FL00 FL00 FL00 FL00 FL00 FL00 FL00 FL00 FL00 FL00 FL00 FL00 FL00 FL00 FL00 WL01
WL01 FL00 FL00 FL00 FL00 FL00 FL00 FL00 FL00 FL00 FL00 FL00 FL00 FL00 WL04 WL04 FL00 FL00 FL00 FL00 FL00 FL00 FL00 FL00 FL00 WL04 FL00 FL00 FL00 FL00 FL00 FL00 FL00 FL00 FL00 FL00 FL00 FL00 FL00 FL00 FL00 FL00 FL00 FL00 FL00 FL00 FL00 FL00 FL00 FL00 FL00 FL00 FL00 FL00 FL00 FL00 FL00 FL00 FL00 WL01
WL01 FL00 FL00 FL00 FL00 FL00 FL00 FL00 FL00 FL00 FL00 FL00 FL00 FL00 WL04 FL00 FL00 FL00 FL00 FL00 FL00 FL00 FL00 FL00 WL04 WL04 FL00 FL00 FL00 FL00 FL00 FL00 FL00 FL00 FL00 FL00 FL00 FL00 FL00 FL00 FL00 FL00 FL00 FL00 FL00 FL00 FL00 FL00 FL00 FL00 FL00 FL00 FL00 FL00 FL00 FL00 FL00 FL00 FL00 WL01
WL01 FL00 FL00 FL00 FL00 FL00 FL00 FL00 FL00 FL00 FL00 FL00 FL00 FL00 WL04 FL00 FL00 FL00 FL00 FL00 FL00 FL00 FL00 WL04 WL04 FL00 FL00 FL00 FL00 FL00 FL00 FL00 FL00 FL00 FL00 FL00 FL00 FL00 FL00 FL00 FL00 FL00 FL00 FL00 FL00 FL00 FL00 FL00 FL00 FL00 FL00 FL00 FL00 FL00 FL00 FL00 FL00 FL00 FL00 WL01
WL01 FL00 FL00 FL00 FL00 FL00 FL00 FL00 FL00 FL00 FL00 FL00 FL00 FL00 WL04 FL00 FL00 FL00 FL00 FL00 FL00 WL04 WL04 WL04 FL00 FL00 FL00 FL00 FL00 FL00 FL00 FL00 FL00 FL00 FL00 FL00 FL00 FL00 FL00 FL00 FL00 FL00 FL00 FL00 FL00 FL00 FL00 FL00 FL00 FL00 FL00 FL00 FL00 FL00 FL00 FL00 FL00 FL00 FL00 WL01
WL01 FL00 FL00 FL00 FL00 FL00 FL00 FL00 FL00 FL00 FL00 FL00 FL00 FL00 FL00 WL04 WL04 WL04 WL04 WL04 WL04 WL04 FL00 FL00 FL00 FL00 FL00 FL00 FL00 FL00 FL00 FL00 FL00 FL00 FL00 FL00 FL00 FL00 FL00 FL00 FL00 FL00 FL00 FL00 FL00 FL00 FL00 FL00 FL00 FL00 FL00 FL00 FL00 FL00 FL00 FL00 FL00 FL00 FL00 WL01
WL01 FL00 FL00 FL00 FL00 FL00 FL00 FL00 FL00 FL00 FL00 FL00 FL00 FL00 FL00 FL00 FL00 FL00 FL00 FL00 FL00 FL00 FL00 FL00 FL00 FL00 FL00 FL00 FL00 FL00 FL00 FL00 FL00 FL00 FL00 FL00 FL00 FL00 FL00 FL00 FL00 FL00 FL00 FL00 FL00 FL00 FL00 FL00 FL00 FL00 FL00 FL00 FL00 FL00 FL00 FL00 FL00 FL00 FL00 WL01
WL01 FL00 FL00 FL00 FL00 FL00 FL00 FL00 FL00 FL00 FL00 FL00 FL00 FL00 FL00 FL00 FL00 FL00 FL00 FL00 FL00 FL00 FL00 FL00 FL00 FL00 FL00 FL00 FL00 FL00 FL00 FL00 FL00 FL00 FL00 FL00 FL00 FL00 FL00 FL00 FL00 FL00 FL00 FL00 FL00 FL00 FL00 FL00 FL00 FL00 FL00 FL00 FL00 FL00 FL00 FL00 FL00 FL00 FL00 WL01
WL01 FL00 FL00 FL00 FL00 FL00 FL00 FL00 FL00 FL00 FL00 FL00 FL00 FL00 FL00 FL00 FL00 FL00 FL00 FL00 FL00 FL00 FL00 FL00 FL00 FL00 FL00 FL00 FL00 FL00 FL00 FL00 FL00 FL00 FL00 FL00 FL00 FL00 FL00 FL00 FL00 FL00 FL00 FL00 FL00 FL00 FL00 FL00 FL00 FL00 FL00 FL00 FL00 FL00 FL00 FL00 FL00 FL00 FL00 WL01
WL01 FL00 FL00 FL00 FL00 FL00 FL00 FL00 FL00 FL00 FL00 FL00 FL00 FL00 FL00 FL00 FL00 FL00 FL00 FL00 FL00 FL00 FL00 FL00 FL00 FL00 FL00 FL00 FL00 FL00 FL00 FL00 FL00 FL00 FL00 FL00 FL00 FL00 FL00 FL00 FL00 FL00 FL00 FL00 FL00 FL00 FL00 FL00 FL00 FL00 FL00 FL00 FL00 FL00 FL00 FL00 FL00 FL00 FL00 WL01
WL01 FL00 FL00 FL00 FL00 FL00 FL00 FL00 FL00 FL00 FL00 FL00 FL00 FL00 FL00 FL00 FL00 FL00 FL00 FL00 FL00 FL00 FL00 FL00 FL00 FL00 FL00 FL00 FL00 FL00 FL00 FL00 FL00 FL00 FL00 FL00 FL00 FL00 FL00 FL00 FL00 FL00 FL00 FL00 FL00 FL00 FL00 FL00 FL00 FL00 FL00 FL00 FL00 FL00 FL00 FL00 FL00 FL00 FL00 WL01
WL01 FL00 FL00 FL00 FL00 FL00 FL00 FL00 FL00 FL00 FL00 FL00 FL00 FL00 FL00 FL00 FL00 FL00 FL00 FL00 FL00 FL00 FL00 FL00 FL00 FL00 FL00 FL00 FL00 FL00 FL00 FL00 FL00 FL00 FL00 FL00 FL00 FL00 FL00 FL00 FL00 FL00 FL00 FL00 FL00 FL00 FL00 FL00 FL00 FL00 FL00 FL00 FL00 FL00 FL00 FL00 FL00 FL00 FL00 WL01
WL01 FL00 FL00 FL00 FL00 FL00 FL00 FL00 FL00 FL00 FL00 FL00 FL00 FL00 FL00 FL00 FL00 FL00 FL00 FL00 FL00 FL00 FL00 FL00 FL00 FL00 FL00 FL00 FL00 FL00 FL00 FL00 FL00 FL00 FL00 FL00 FL00 FL00 FL00 FL00 FL00 FL00 FL00 FL00 FL00 FL00 FL00 FL00 FL00 FL00 FL00 FL00 FL00 FL00 FL00 FL00 FL00 FL00 FL00 WL01
WL01 FL00 FL00 FL00 FL00 FL00 FL00 FL00 FL00 FL00 FL00 FL00 FL00 FL00 FL00 FL00 FL00 FL00 FL00 FL00 FL00 FL00 FL00 FL00 FL00 FL00 FL00 FL00 FL00 FL00 FL00 FL00 FL00 FL00 FL00 FL00 FL00 FL00 FL00 FL00 FL00 FL00 FL00 FL00 FL00 FL00 FL00 FL00 FL00 FL00 FL00 FL00 FL00 FL00 FL00 FL00 FL00 FL00 FL00 WL01
WL01 FL00 FL00 FL00 FL00 FL00 FL00 FL00 FL00 FL00 FL00 FL00 FL00 FL00 FL00 FL00 FL00 FL00 FL00 FL00 FL00 FL00 FL00 FL00 FL00 FL00 FL00 FL00 FL00 FL00 FL00 FL00 FL00 FL00 FL00 FL00 FL00 FL00 FL00 FL00 FL00 FL00 FL00 FL00 FL00 FL00 FL00 FL00 FL00 FL00 FL00 FL00 FL00 FL00 FL00 FL00 FL00 FL00 FL00 WL01
WL01 FL00 FL00 FL00 FL00 FL00 FL00 FL00 FL00 FL00 FL00 FL00 FL00 FL00 FL00 FL00 FL00 FL00 FL00 FL00 FL00 FL00 FL00 FL00 FL00 FL00 FL00 FL00 FL00 FL00 FL00 FL00 FL00 FL00 FL00 FL00 FL00 FL00 FL00 FL00 FL00 FL00 FL00 FL00 FL00 FL00 FL00 FL00 FL00 FL00 FL00 FL00 FL00 FL00 FL00 FL00 FL00 FL00 FL00 WL01
WL01 FL00 FL00 FL00 FL00 FL00 FL00 FL00 FL00 FL00 FL00 FL00 FL00 FL00 FL00 FL00 FL00 FL00 FL00 FL00 FL00 FL00 FL00 FL00 FL00 FL00 FL00 FL00 FL00 FL00 FL00 FL00 FL00 FL00 FL00 FL00 FL00 FL00 FL00 FL00 FL00 FL00 FL00 FL00 FL00 FL00 FL00 FL00 FL00 FL00 FL00 FL00 FL00 FL00 FL00 FL00 FL00 FL00 FL00 WL01
WL01 FL00 FL00 FL00 FL00 FL00 FL00 FL00 FL00 FL00 FL00 FL00 FL00 FL00 FL00 FL00 FL00 FL00 FL00 FL00 FL00 FL00 FL00 FL00 FL00 FL00 FL00 FL00 FL00 FL00 FL00 FL00 FL00 FL00 FL00 FL00 FL00 FL00 FL00 FL00 FL00 FL00 FL00 FL00 FL00 FL00 FL00 FL00 FL00 FL00 FL00 FL00 FL00 FL00 FL00 FL00 FL00 FL00 FL00 WL01
WL01 FL00 FL00 FL00 FL00 FL00 FL00 FL00 FL00 FL00 FL00 FL00 FL00 FL00 FL00 FL00 FL00 FL00 FL00 FL00 FL00 FL00 FL00 FL00 FL00 FL00 FL00 FL00 FL00 FL00 FL00 FL00 FL00 FL00 FL00 FL00 FL00 FL00 FL00 FL00 FL00 FL00 FL00 FL00 FL00 FL00 FL00 FL00 FL00 FL00 FL00 FL00 FL00 FL00 FL00 FL00 FL00 FL00 FL00 WL01
WL01 FL00 FL00 FL00 FL00 FL00 FL00 FL00 FL00 FL00 FL00 FL00 FL00 FL00 FL00 FL00 FL00 FL00 FL00 FL00 FL00 FL00 FL00 FL00 FL00 FL00 FL00 FL00 FL00 FL00 FL00 FL00 FL00 FL00 FL00 FL00 FL00 FL00 FL00 FL00 FL00 FL00 FL00 FL00 FL00 FL00 FL00 FL00 FL00 FL00 FL00 FL00 FL00 FL00 FL00 FL00 FL00 FL00 FL00 WL01
WL01 FL00 FL00 FL00 FL00 FL00 FL00 FL00 FL00 FL00 FL00 FL00 FL00 FL00 FL00 FL00 FL00 FL00 FL00 FL00 FL00 FL00 FL00 FL00 FL00 FL00 FL00 FL00 FL00 FL00 FL00 FL00 FL00 FL00 FL00 FL00 FL00 FL00 FL00 FL00 FL00 FL00 FL00 FL00 FL00 FL00 FL00 FL00 FL00 FL00 FL00 FL00 FL00 FL00 FL00 FL00 FL00 FL00 FL00 WL01
WL01 FL00 FL00 FL00 FL00 FL00 FL00 FL00 FL00 FL00 FL00 FL00 FL00 FL00 FL00 FL00 FL00 FL00 FL00 FL00 FL00 FL00 FL00 FL00 FL00 FL00 FL00 FL00 FL00 FL00 FL00 FL00 FL00 FL00 FL00 FL00 FL00 FL00 FL00 FL00 FL00 FL00 FL00 FL00 FL00 FL00 FL00 FL00 FL00 FL00 FL00 FL00 FL00 FL00 FL00 FL00 FL00 FL00 FL00 WL01
WL01 FL00 FL00 FL00 FL00 FL00 FL00 FL00 FL00 FL00 FL00 FL00 FL00 FL00 FL00 FL00 FL00 FL00 FL00 FL00 FL00 FL00 FL00 FL00 FL00 FL00 FL00 FL00 FL00 FL00 FL00 FL00 FL00 FL00 FL00 FL00 FL00 FL00 FL00 FL00 FL00 FL00 FL00 FL00 FL00 FL00 FL00 FL00 FL00 FL00 FL00 FL00 FL00 FL00 FL00 FL00 FL00 FL00 FL00 WL01
WL01 FL00 FL00 FL00 FL00 FL00 FL00 FL00 FL00 FL00 FL00 FL00 FL00 FL00 FL00 FL00 FL00 FL00 FL00 FL00 FL00 FL00 FL00 FL00 FL00 FL00 FL00 FL00 FL00 FL00 FL00 FL00 FL00 FL00 FL00 FL00 FL00 FL00 FL00 FL00 FL00 FL00 FL00 FL00 FL00 FL00 FL00 FL00 FL00 FL00 FL00 FL00 FL00 FL00 FL00 FL00 FL00 FL00 FL00 WL01
WL01 FL00 FL00 FL00 FL00 FL00 FL00 FL00 FL00 FL00 FL00 FL00 FL00 FL00 FL00 FL00 FL00 FL00 FL00 FL00 FL00 FL00 FL00 FL00 FL00 FL00 FL00 FL00 FL00 FL00 FL00 FL00 FL00 FL00 FL00 FL00 FL00 FL00 FL00 FL00 FL00 FL00 FL00 FL00 FL00 FL00 FL00 FL00 FL00 FL00 FL00 FL00 FL00 FL00 FL00 FL00 FL00 FL00 FL00 WL01
WL01 FL00 FL00 FL00 FL00 FL00 FL00 FL00 FL00 FL00 FL00 FL00 FL00 FL00 FL00 FL00 FL00 FL00 FL00 FL00 FL00 FL00 FL00 FL00 FL00 FL00 FL00 FL00 FL00 FL00 FL00 FL00 FL00 FL00 FL00 FL00 FL00 FL00 FL00 FL00 FL00 FL00 FL00 FL00 FL00 FL00 FL00 FL00 FL00 FL00 FL00 FL00 FL00 FL00 FL00 FL00 FL00 FL00 FL00 WL01
WL01 FL00 FL00 FL00 FL00 FL00 FL00 FL00 FL00 FL00 FL00 FL00 FL00 FL00 FL00 FL00 FL00 FL00 FL00 FL00 FL00 FL00 FL00 FL00 FL00 FL00 FL00 FL00 FL00 FL00 FL00 FL00 FL00 FL00 FL00 FL00 FL00 FL00 FL00 FL00 FL00 FL00 FL00 FL00 FL00 FL00 FL00 FL00 FL00 FL00 FL00 FL00 FL00 FL00 FL00 FL00 FL00 FL00 FL00 WL01
WL01 FL00 FL00 FL00 FL00 FL00 FL00 FL00 FL00 FL00 FL00 FL00 FL00 FL00 FL00 FL00 FL00 FL00 FL00 FL00 FL00 FL00 FL00 FL00 FL00 FL00 FL00 FL00 FL00 FL00 FL00 FL00 FL00 FL00 FL00 FL00 FL00 FL00 FL00 FL00 FL00 FL00 FL00 FL00 FL00 FL00 FL00 FL00 FL00 FL00 FL00 FL00 FL00 FL00 FL00 FL00 FL00 FL00 FL00 WL01
WL01 FL00 FL00 FL00 FL00 FL00 FL00 FL00 FL00 FL00 FL00 FL00 FL00 FL00 FL00 FL00 FL00 FL00 FL00 FL00 FL00 FL00 FL00 FL00 FL00 FL00 FL00 FL00 FL00 FL00 FL00 FL00 FL00 FL00 FL00 FL00 FL00 FL00 FL00 FL00 FL00 FL00 FL00 FL00 FL00 FL00 FL00 FL00 FL00 FL00 FL00 FL00 FL00 FL00 FL00 FL00 FL00 FL00 FL00 WL01
WL01 FL00 FL00 FL00 FL00 FL00 FL00 FL00 FL00 FL00 FL00 FL00 FL00 FL00 FL00 FL00 FL00 FL00 FL00 FL00 FL00 FL00 FL00 FL00 FL00 FL00 FL00 FL00 FL00 FL00 FL00 FL00 FL00 FL00 FL00 FL00 FL00 FL00 FL00 FL00 FL00 FL00 FL00 FL00 FL00 FL00 FL00 FL00 FL00 FL00 FL00 FL00 FL00 FL00 FL00 FL00 FL00 FL00 FL00 WL01
WL01 FL00 FL00 FL00 FL00 FL00 FL00 FL00 FL00 FL00 FL00 FL00 FL00 FL00 FL00 FL00 FL00 FL00 FL00 FL00 FL00 FL00 FL00 FL00 FL00 FL00 FL00 FL00 FL00 FL00 FL00 FL00 FL00 FL00 FL00 FL00 FL00 FL00 FL00 FL00 FL00 FL00 FL00 FL00 FL00 FL00 FL00 FL00 FL00 FL00 FL00 FL00 FL00 FL00 FL00 FL00 FL00 FL00 FL00 WL01
WL01 FL00 FL00 FL00 FL00 FL00 FL00 FL00 FL00 FL00 FL00 FL00 FL00 FL00 FL00 FL00 FL00 FL00 FL00 FL00 FL00 FL00 FL00 FL00 FL00 FL00 FL00 FL00 FL00 FL00 FL00 FL00 FL00 FL00 FL00 FL00 FL00 FL00 FL00 FL00 FL00 FL00 FL00 FL00 FL00 FL00 FL00 FL00 FL00 FL00 FL00 FL00 FL00 FL00 FL00 FL00 FL00 FL00 FL00 WL01
WL01 FL00 FL00 FL00 FL00 FL00 FL00 FL00 FL00 FL00 FL00 FL00 FL00 FL00 FL00 FL00 FL00 FL00 FL00 FL00 FL00 FL00 FL00 FL00 FL00 FL00 FL00 FL00 FL00 FL00 FL00 FL00 FL00 FL00 FL00 FL00 FL00 FL00 FL00 FL00 FL00 FL00 FL00 FL00 FL00 FL00 FL00 FL00 FL00 FL00 FL00 FL00 FL00 FL00 FL00 FL00 FL00 FL00 FL00 WL01
WL01 FL00 FL00 FL00 FL00 FL00 FL00 FL00 FL00 FL00 FL00 FL00 FL00 FL00 FL00 FL00 FL00 FL00 FL00 FL00 FL00 FL00 FL00 FL00 FL00 FL00 FL00 FL00 FL00 FL00 FL00 FL00 FL00 FL00 FL00 FL00 FL00 FL00 FL00 FL00 FL00 FL00 FL00 FL00 FL00 FL00 FL00 FL00 FL00 FL00 FL00 FL00 FL00 FL00 FL00 FL00 FL00 FL00 FL00 WL01
WL01 FL00 FL00 FL00 FL00 FL00 FL00 FL00 FL00 FL00 FL00 FL00 FL00 FL00 FL00 FL00 FL00 FL00 FL00 FL00 FL00 FL00 FL00 FL00 FL00 FL00 FL00 FL00 FL00 FL00 FL00 FL00 FL00 FL00 FL00 FL00 FL00 FL00 FL00 FL00 FL00 FL00 FL00 FL00 FL00 FL00 FL00 FL00 FL00 FL00 FL00 FL00 FL00 FL00 FL00 FL00 FL00 FL00 FL00 WL01
WL01 FL00 FL00 FL00 FL00 FL00 FL00 FL00 FL00 FL00 FL00 FL00 FL00 FL00 FL00 FL00 FL00 FL00 FL00 FL00 FL00 FL00 FL00 FL00 FL00 FL00 FL00 FL00 FL00 FL00 FL00 FL00 FL00 FL00 FL00 FL00 FL00 FL00 FL00 FL00 FL00 FL00 FL00 FL00 FL00 FL00 FL00 FL00 FL00 FL00 FL00 FL00 FL00 FL00 FL00 FL00 FL00 FL00 FL00 WL01
WL01 WL01 WL01 WL01 WL01 WL01 WL01 WL01 WL01 WL01 WL01 WL01 WL01 WL01 WL01 WL01 WL01 WL01 WL01 WL01 WL01 WL01 WL01 WL01 WL01 WL01 WL01 WL01 WL01 WL01 WL01 WL01 WL01 WL01 WL01 WL01 WL01 WL01 WL01 WL01 WL01 WL01 WL01 WL01 WL01 WL01 WL01 WL01 WL01 WL01 WL01 WL01 WL01 WL01 WL01 WL01 WL01 WL01 WL01 WL01
